division,district,upazila,union,depth 0+,depth 0-90,depth 90+,depth 90-150,depth 150+,depth 0-15.3,depth 15.3-45,depth 45-65,depth 65-90
Chittagong,Lakshmipur,Lakshmipur Sadar,Tiariganj,78,3,75,0,75,3,0,0,0
Chittagong,Lakshmipur,Lakshmipur Sadar,Char Ramani Mohan,31,3,28,0,28,3,0,0,0
Chittagong,Lakshmipur,Lakshmipur Sadar,Lakshmipur Paurashava,29,1,28,0,28,0,1,0,0
Chittagong,Lakshmipur,Lakshmipur Sadar,Tum Char,67,1,66,0,66,1,0,0,0
Chittagong,Lakshmipur,Lakshmipur Sadar,Kushakhali,633,578,55,0,55,0,569,8,1
Chittagong,Lakshmipur,Lakshmipur Sadar,Uttar Hamchadi,2439,2207,232,14,218,0,1655,482,70
Chittagong,Lakshmipur,Lakshmipur Sadar,Dakshin Hamchadi,1546,1375,171,5,166,0,1115,231,29
Chittagong,Lakshmipur,Lakshmipur Sadar,Laharkandi,1740,1655,85,0,85,0,1492,142,21
Chittagong,Lakshmipur,Lakshmipur Sadar,Mandari,2166,2020,146,3,143,0,1861,142,17
Chittagong,Lakshmipur,Lakshmipur Sadar,Parbatinagar,1408,1364,44,8,36,0,1257,81,26
Chittagong,Lakshmipur,Lakshmipur Sadar,Shak Char,1445,1251,194,1,193,0,1172,68,11
Chittagong,Lakshmipur,Lakshmipur Sadar,Char Ruhita,693,477,216,1,215,0,437,34,6
Chittagong,Lakshmipur,Lakshmipur Sadar,Bangakha,1952,1910,42,2,40,0,1677,210,23
Chittagong,Lakshmipur,Lakshmipur Sadar,Dalal Bazar,1398,1163,235,6,229,0,612,489,62
Chittagong,Lakshmipur,Lakshmipur Sadar,Bhabaniganj,2260,2014,246,4,242,0,1857,142,15
Chittagong,Lakshmipur,Lakshmipur Sadar,Uttar Joypur,1771,1690,81,1,80,0,1289,363,38
Chittagong,Lakshmipur,Lakshmipur Sadar,Datta Para,3263,3137,126,13,113,0,2608,441,88
Chittagong,Lakshmipur,Lakshmipur Sadar,Charsai,2379,2325,54,2,52,0,2210,101,14
Chittagong,Lakshmipur,Lakshmipur Sadar,Basikpur,3101,2890,211,8,203,0,2332,455,103
Chittagong,Lakshmipur,Lakshmipur Sadar,Dighali,1954,1913,41,3,38,0,1732,152,29
Chittagong,Lakshmipur,Lakshmipur Sadar,Hajir Para,2466,2415,51,5,46,0,1991,368,56
Chittagong,Lakshmipur,Lakshmipur Sadar,Chandraganj,3069,3004,65,6,59,0,2604,365,35
Chittagong,Lakshmipur,Lakshmipur Sadar,###,35888,33396,2492,82,2410,7,28471,4274,644
Chittagong,Lakshmipur,Ramgati,Bara Kheri,2,1,1,0,1,1,0,0,0
Chittagong,Lakshmipur,Ramgati,Char Ramiz,69,0,69,0,69,0,0,0,0
Chittagong,Lakshmipur,Ramgati,Char Alexandar,61,1,60,0,60,1,0,0,0
Chittagong,Lakshmipur,Ramgati,Char Algi,25,1,24,0,24,1,0,0,0
Chittagong,Lakshmipur,Ramgati,Char Bedam,17,1,16,0,16,1,0,0,0
Chittagong,Lakshmipur,Ramgati,Char Poragacha,34,0,34,0,34,0,0,0,0
Chittagong,Lakshmipur,Ramgati,Ramgati Paurashava,5,0,5,0,5,0,0,0,0
Chittagong,Lakshmipur,Ramgati,Char Gazi,2,0,2,0,2,0,0,0,0
Chittagong,Lakshmipur,Ramgati,Char Abdullah,3,0,3,0,3,0,0,0,0
Chittagong,Lakshmipur,Ramgati,###,218,4,214,0,214,4,0,0,0
Chittagong,Lakshmipur,Kamalnagar,Torabgang,93,1,92,0,92,1,0,0,0
Chittagong,Lakshmipur,Kamalnagar,Hajirhat,63,0,63,0,63,0,0,0,0
Chittagong,Lakshmipur,Kamalnagar,Char Lawrence,60,1,59,0,59,1,0,0,0
Chittagong,Lakshmipur,Kamalnagar,Char Falcon,23,0,23,0,23,0,0,0,0
Chittagong,Lakshmipur,Kamalnagar,Patarir Hat,69,1,68,0,68,1,0,0,0
Chittagong,Lakshmipur,Kamalnagar,Saheberhat,54,0,54,0,54,0,0,0,0
Chittagong,Lakshmipur,Kamalnagar,Char Martin,33,1,32,0,32,1,0,0,0
Chittagong,Lakshmipur,Kamalnagar,Char Kalkini,14,0,14,0,14,0,0,0,0
Chittagong,Lakshmipur,Kamalnagar,Char Kadira,23,0,23,0,23,0,0,0,0
Chittagong,Lakshmipur,Kamalnagar,###,432,4,428,0,428,4,0,0,0
Chittagong,Lakshmipur,Roypur,Roypur Paurashava,57,1,56,0,56,1,0,0,0
Chittagong,Lakshmipur,Roypur,Keroa,203,1,202,0,202,1,0,0,0
Chittagong,Lakshmipur,Roypur,Royipur,118,0,118,0,118,0,0,0,0
Chittagong,Lakshmipur,Roypur,North Char Ababil,140,0,140,0,140,0,0,0,0
Chittagong,Lakshmipur,Roypur,South Char Bangshi Union,131,0,131,0,131,0,0,0,0
Chittagong,Lakshmipur,Roypur,Bamni,118,0,118,0,118,0,0,0,0
Chittagong,Lakshmipur,Roypur,South Char Ababil,147,1,146,0,146,1,0,0,0
Chittagong,Lakshmipur,Roypur,North Char Bangshi,145,1,144,0,144,1,0,0,0
Chittagong,Lakshmipur,Roypur,Char Mohana,181,1,180,0,180,1,0,0,0
Chittagong,Lakshmipur,Roypur,Char Pata,90,0,90,0,90,0,0,0,0
Chittagong,Lakshmipur,Roypur,Sonapur,133,1,132,0,132,1,0,0,0
Chittagong,Lakshmipur,Roypur,###,1463,6,1457,0,1457,6,0,0,0
Chittagong,Lakshmipur,Ramganj,Lamchar,12,0,12,0,12,0,0,0,0
Chittagong,Lakshmipur,Ramganj,Noagaon,3,0,3,0,3,0,0,0,0
Chittagong,Lakshmipur,Ramganj,Bhatra,9,2,7,0,7,1,1,0,0
Chittagong,Lakshmipur,Ramganj,Ramganj Paurashava,49,1,48,0,48,0,1,0,0
Chittagong,Lakshmipur,Ramganj,Chandipur,7,3,4,0,4,3,0,0,0
Chittagong,Lakshmipur,Ramganj,Bhadur,2,1,1,0,1,0,1,0,0
Chittagong,Lakshmipur,Ramganj,Karpara,2,1,1,0,1,1,0,0,0
Chittagong,Lakshmipur,Ramganj,Ichhapur,1,1,0,0,0,0,1,0,0
Chittagong,Lakshmipur,Ramganj,Kanchanpur,1,1,0,0,0,0,1,0,0
Chittagong,Lakshmipur,Ramganj,Bholakot,0,0,0,0,0,0,0,0,0
Chittagong,Lakshmipur,Ramganj,Darbeshpur,0,0,0,0,0,0,0,0,0
Chittagong,Lakshmipur,Ramganj,###,86,10,76,0,76,5,5,0,0
Chittagong,Lakshmipur,###,###,38087,33420,4667,82,4585,26,28476,4274,644
Chittagong,Chandpur,Kachua,Ashrafpur,2,1,1,0,1,0,1,0,0
Chittagong,Chandpur,Kachua,Kadla,4,3,1,1,0,0,3,0,0
Chittagong,Chandpur,Kachua,Purba Sahadebpur,1,1,0,0,0,0,1,0,0
Chittagong,Chandpur,Kachua,Uttar Kachua,1,1,0,0,0,0,1,0,0
Chittagong,Chandpur,Kachua,Pathair,1,1,0,0,0,0,1,0,0
Chittagong,Chandpur,Kachua,Sachar,2,1,1,0,1,0,1,0,0
Chittagong,Chandpur,Kachua,Uttar Gohat,1,1,0,0,0,0,1,0,0
Chittagong,Chandpur,Kachua,Karaia,3,0,3,0,3,0,0,0,0
Chittagong,Chandpur,Kachua,Bitara,0,0,0,0,0,0,0,0,0
Chittagong,Chandpur,Kachua,Dakshin Gohat,0,0,0,0,0,0,0,0,0
Chittagong,Chandpur,Kachua,Dakshin Kachua,0,0,0,0,0,0,0,0,0
Chittagong,Chandpur,Kachua,Kachua Paurashava,0,0,0,0,0,0,0,0,0
Chittagong,Chandpur,Kachua,Paschim Sahadebpur,0,0,0,0,0,0,0,0,0
Chittagong,Chandpur,Kachua,###,15,9,6,1,5,0,9,0,0
Chittagong,Chandpur,Hajiganj,Purba Barkul,1,0,1,0,1,0,0,0,0
Chittagong,Chandpur,Hajiganj,Dakshin Gandharbapur,3,1,2,0,2,0,1,0,0
Chittagong,Chandpur,Hajiganj,Hajiganj Paurashava,1,0,1,1,0,0,0,0,0
Chittagong,Chandpur,Hajiganj,Hajiganj,2,2,0,0,0,0,2,0,0
Chittagong,Chandpur,Hajiganj,Bakila,1,1,0,0,0,0,1,0,0
Chittagong,Chandpur,Hajiganj,Uttar Kalocho,1,1,0,0,0,0,1,0,0
Chittagong,Chandpur,Hajiganj,Uttar Gandharabpur,1,1,0,0,0,0,1,0,0
Chittagong,Chandpur,Hajiganj,Paschim Barkul,1,1,0,0,0,0,1,0,0
Chittagong,Chandpur,Hajiganj,Dakshin Kalocho,0,0,0,0,0,0,0,0,0
Chittagong,Chandpur,Hajiganj,Hatila Purba,0,0,0,0,0,0,0,0,0
Chittagong,Chandpur,Hajiganj,Pachim Hatila,0,0,0,0,0,0,0,0,0
Chittagong,Chandpur,Hajiganj,Uttar Rajargaon,0,0,0,0,0,0,0,0,0
Chittagong,Chandpur,Hajiganj,###,11,7,4,1,3,0,7,0,0
Chittagong,Chandpur,Haim Char,Char Bhairabi,7,1,6,0,6,0,1,0,0
Chittagong,Chandpur,Haim Char,Dakshin Algi Durgapur,1,0,1,0,1,0,0,0,0
Chittagong,Chandpur,Haim Char,Uttar Algi Durgapur,3,1,2,0,2,0,1,0,0
Chittagong,Chandpur,Haim Char,Gazipur,0,0,0,0,0,0,0,0,0
Chittagong,Chandpur,Haim Char,Haim Char,0,0,0,0,0,0,0,0,0
Chittagong,Chandpur,Haim Char,Nilkamal,0,0,0,0,0,0,0,0,0
Chittagong,Chandpur,Haim Char,###,11,2,9,0,9,0,2,0,0
Chittagong,Chandpur,Faridganj,Paschim Char Dukhia,1,0,1,0,1,0,0,0,0
Chittagong,Chandpur,Faridganj,Purba Char Dukhia,4,0,4,0,4,0,0,0,0
Chittagong,Chandpur,Faridganj,Dakshin Rupsa,2,1,1,0,1,0,1,0,0
Chittagong,Chandpur,Faridganj,Dakshin Faridganj,4,1,3,0,3,1,0,0,0
Chittagong,Chandpur,Faridganj,Purba Baluthupa,1,0,1,0,1,0,0,0,0
Chittagong,Chandpur,Faridganj,Faridganj Paurashava,4,1,3,0,3,1,0,0,0
Chittagong,Chandpur,Faridganj,Purba Gupti,1,1,0,0,0,0,1,0,0
Chittagong,Chandpur,Faridganj,Paschim Subidpur,1,1,0,0,0,1,0,0,0
Chittagong,Chandpur,Faridganj,Uttar Gobindapur,1,1,0,0,0,0,1,0,0
Chittagong,Chandpur,Faridganj,Uttar Rupsa,1,1,0,0,0,1,0,0,0
Chittagong,Chandpur,Faridganj,Paschim Baluthupa,1,1,0,0,0,0,1,0,0
Chittagong,Chandpur,Faridganj,Dakshin Paik Para,1,1,0,0,0,0,1,0,0
Chittagong,Chandpur,Faridganj,Dakshin Gobindapur,0,0,0,0,0,0,0,0,0
Chittagong,Chandpur,Faridganj,Paschim Gupti,0,0,0,0,0,0,0,0,0
Chittagong,Chandpur,Faridganj,Purba Subidpur,0,0,0,0,0,0,0,0,0
Chittagong,Chandpur,Faridganj,Uttar Paikpara,0,0,0,0,0,0,0,0,0
Chittagong,Chandpur,Faridganj,###,22,9,13,0,13,4,5,0,0
Chittagong,Chandpur,Matlab Uttar,Mohanpur,6,1,5,0,5,0,1,0,0
Chittagong,Chandpur,Matlab Uttar,Satnal,1,1,0,0,0,0,1,0,0
Chittagong,Chandpur,Matlab Uttar,Paschim Fatehpur,1,1,0,0,0,0,1,0,0
Chittagong,Chandpur,Matlab Uttar,Farajikandi,1,1,0,0,0,0,1,0,0
Chittagong,Chandpur,Matlab Uttar,Baganbari,0,0,0,0,0,0,0,0,0
Chittagong,Chandpur,Matlab Uttar,Durgapur,0,0,0,0,0,0,0,0,0
Chittagong,Chandpur,Matlab Uttar,Eklaspur,0,0,0,0,0,0,0,0,0
Chittagong,Chandpur,Matlab Uttar,Gajra,0,0,0,0,0,0,0,0,0
Chittagong,Chandpur,Matlab Uttar,Islamabad,0,0,0,0,0,0,0,0,0
Chittagong,Chandpur,Matlab Uttar,Jahirabad,0,0,0,0,0,0,0,0,0
Chittagong,Chandpur,Matlab Uttar,Kalakanda,0,0,0,0,0,0,0,0,0
Chittagong,Chandpur,Matlab Uttar,Purba Fatehpur,0,0,0,0,0,0,0,0,0
Chittagong,Chandpur,Matlab Uttar,Sadullapur,0,0,0,0,0,0,0,0,0
Chittagong,Chandpur,Matlab Uttar,Sengarchar Paurashava,0,0,0,0,0,0,0,0,0
Chittagong,Chandpur,Matlab Uttar,Sultanabad,0,0,0,0,0,0,0,0,0
Chittagong,Chandpur,Matlab Uttar,###,9,4,5,0,5,0,4,0,0
Chittagong,Chandpur,Chandpur Sadar,Rampur,1,0,1,0,1,0,0,0,0
Chittagong,Chandpur,Chandpur Sadar,Chandpur Paurashava,2,1,1,1,0,0,1,0,0
Chittagong,Chandpur,Chandpur Sadar,Ashikati,1,1,0,0,0,0,1,0,0
Chittagong,Chandpur,Chandpur Sadar,Bishnupur,1,1,0,0,0,0,1,0,0
Chittagong,Chandpur,Chandpur Sadar,Balia,1,1,0,0,0,0,1,0,0
Chittagong,Chandpur,Chandpur Sadar,Chandra,1,1,0,0,0,0,1,0,0
Chittagong,Chandpur,Chandpur Sadar,Tarpur Chandi,2,1,1,0,1,0,1,0,0
Chittagong,Chandpur,Chandpur Sadar,Shah Mahmudpur,1,1,0,0,0,0,1,0,0
Chittagong,Chandpur,Chandpur Sadar,Ibrahimpur,1,1,0,0,0,0,1,0,0
Chittagong,Chandpur,Chandpur Sadar,Baghadi,1,1,0,0,0,0,1,0,0
Chittagong,Chandpur,Chandpur Sadar,Hanar Char,0,0,0,0,0,0,0,0,0
Chittagong,Chandpur,Chandpur Sadar,Kalyanpur,0,0,0,0,0,0,0,0,0
Chittagong,Chandpur,Chandpur Sadar,Maishadi,0,0,0,0,0,0,0,0,0
Chittagong,Chandpur,Chandpur Sadar,Rajrajeshwar,0,0,0,0,0,0,0,0,0
Chittagong,Chandpur,Chandpur Sadar,Sakhua,0,0,0,0,0,0,0,0,0
Chittagong,Chandpur,Chandpur Sadar,###,12,9,3,1,2,0,9,0,0
Chittagong,Chandpur,Shahrasti,Uttar Suchi Para,8,1,7,0,7,0,1,0,0
Chittagong,Chandpur,Shahrasti,Tamta Paschim,1,1,0,0,0,0,1,0,0
Chittagong,Chandpur,Shahrasti,East Chitasi,1,1,0,0,0,0,1,0,0
Chittagong,Chandpur,Shahrasti,Shahrasti Paurashava,1,1,0,0,0,0,1,0,0
Chittagong,Chandpur,Shahrasti,Uttar Roysree,1,1,0,0,0,0,1,0,0
Chittagong,Chandpur,Shahrasti,Dakshin Meher,1,1,0,0,0,0,1,0,0
Chittagong,Chandpur,Shahrasti,Dakshin Roysree,1,0,1,0,1,0,0,0,0
Chittagong,Chandpur,Shahrasti,Dakshin Suchi Para,5,0,5,0,5,0,0,0,0
Chittagong,Chandpur,Shahrasti,Tamta Purba,0,0,0,0,0,0,0,0,0
Chittagong,Chandpur,Shahrasti,Uttar Meher,0,0,0,0,0,0,0,0,0
Chittagong,Chandpur,Shahrasti,West Chitasi,0,0,0,0,0,0,0,0,0
Chittagong,Chandpur,Shahrasti,###,19,6,13,0,13,0,6,0,0
Chittagong,Chandpur,Matlab Dakshin,Narayanpur,1,1,0,0,0,0,1,0,0
Chittagong,Chandpur,Matlab Dakshin,Matlab Paurashava,2,2,0,0,0,0,1,1,0
Chittagong,Chandpur,Matlab Dakshin,Khadergaon,1,1,0,0,0,0,1,0,0
Chittagong,Chandpur,Matlab Dakshin,Dakhsin Nayergaon,0,0,0,0,0,0,0,0,0
Chittagong,Chandpur,Matlab Dakshin,Dakshin Upadi,0,0,0,0,0,0,0,0,0
Chittagong,Chandpur,Matlab Dakshin,Uttar Nayergaon,0,0,0,0,0,0,0,0,0
Chittagong,Chandpur,Matlab Dakshin,Uttar Upadi,0,0,0,0,0,0,0,0,0
Chittagong,Chandpur,Matlab Dakshin,###,4,4,0,0,0,0,3,1,0
Chittagong,Chandpur,###,###,103,50,53,3,50,4,45,1,0
Chittagong,Noakhali,Kabirhat,Bataiya,3,0,3,0,3,0,0,0,0
Chittagong,Noakhali,Kabirhat,Sundalpur,8,0,8,0,8,0,0,0,0
Chittagong,Noakhali,Kabirhat,Dhan Shalik,1,0,1,0,1,0,0,0,0
Chittagong,Noakhali,Kabirhat,Narottampur,3,1,2,0,2,0,1,0,0
Chittagong,Noakhali,Kabirhat,Chaprashirhat,29,1,28,0,28,1,0,0,0
Chittagong,Noakhali,Kabirhat,Ghoshbagh,7,0,7,0,7,0,0,0,0
Chittagong,Noakhali,Kabirhat,Kabirhat Paurashava,2,0,2,0,2,0,0,0,0
Chittagong,Noakhali,Kabirhat,Dhan Siri,0,0,0,0,0,0,0,0,0
Chittagong,Noakhali,Kabirhat,###,53,2,51,0,51,1,1,0,0
Chittagong,Noakhali,Noakhali Sadar (Sudharam),Binodpur,6,0,6,0,6,0,0,0,0
Chittagong,Noakhali,Noakhali Sadar (Sudharam),Kaladaraf,222,0,222,0,222,0,0,0,0
Chittagong,Noakhali,Noakhali Sadar (Sudharam),Ewazbalia,200,1,199,0,199,1,0,0,0
Chittagong,Noakhali,Noakhali Sadar (Sudharam),Noannai,101,1,100,0,100,1,0,0,0
Chittagong,Noakhali,Noakhali Sadar (Sudharam),Noakhali Paurashava,4,2,2,0,2,2,0,0,0
Chittagong,Noakhali,Noakhali Sadar (Sudharam),Dadpur,113,0,113,0,113,0,0,0,0
Chittagong,Noakhali,Noakhali Sadar (Sudharam),Kadir Hanif,13,0,13,0,13,0,0,0,0
Chittagong,Noakhali,Noakhali Sadar (Sudharam),Ashwadia,6,1,5,0,5,1,0,0,0
Chittagong,Noakhali,Noakhali Sadar (Sudharam),Noakhali,87,0,87,0,87,0,0,0,0
Chittagong,Noakhali,Noakhali Sadar (Sudharam),Purba Char Matua,115,0,115,0,115,0,0,0,0
Chittagong,Noakhali,Noakhali Sadar (Sudharam),Anderchar,32,0,32,0,32,0,0,0,0
Chittagong,Noakhali,Noakhali Sadar (Sudharam),Char Matua,113,1,112,0,112,1,0,0,0
Chittagong,Noakhali,Noakhali Sadar (Sudharam),Dharmapur,6,0,6,0,6,0,0,0,0
Chittagong,Noakhali,Noakhali Sadar (Sudharam),Niazpur,0,0,0,0,0,0,0,0,0
Chittagong,Noakhali,Noakhali Sadar (Sudharam),###,1018,6,1012,0,1012,6,0,0,0
Chittagong,Noakhali,Sonaimuri,Amisha Para,108,1,107,0,107,1,0,0,0
Chittagong,Noakhali,Sonaimuri,Ambarnagar,160,0,160,0,160,0,0,0,0
Chittagong,Noakhali,Sonaimuri,Baragaon,14,1,13,0,13,1,0,0,0
Chittagong,Noakhali,Sonaimuri,Bazra,138,0,138,0,138,0,0,0,0
Chittagong,Noakhali,Sonaimuri,Nateshwar,155,0,155,0,155,0,0,0,0
Chittagong,Noakhali,Sonaimuri,Deoti,92,0,92,0,92,0,0,0,0
Chittagong,Noakhali,Sonaimuri,Jayag,154,1,153,0,153,1,0,0,0
Chittagong,Noakhali,Sonaimuri,Nadana,111,0,111,0,111,0,0,0,0
Chittagong,Noakhali,Sonaimuri,Sonaimuri Paurashava,6,1,5,0,5,1,0,0,0
Chittagong,Noakhali,Sonaimuri,Chashirhat,4,0,4,0,4,0,0,0,0
Chittagong,Noakhali,Sonaimuri,Sonapur,112,0,112,0,112,0,0,0,0
Chittagong,Noakhali,Sonaimuri,###,1054,4,1050,0,1050,4,0,0,0
Chittagong,Noakhali,Begumganj,Chhayani,166,1,165,0,165,1,0,0,0
Chittagong,Noakhali,Begumganj,Rasulpur,128,0,128,0,128,0,0,0,0
Chittagong,Noakhali,Begumganj,Alyerapur,157,0,157,0,157,0,0,0,0
Chittagong,Noakhali,Begumganj,Amanullapur,85,1,84,0,84,1,0,0,0
Chittagong,Noakhali,Begumganj,Kutubpur,145,1,144,0,144,1,0,0,0
Chittagong,Noakhali,Begumganj,Chaumohani Paurashava,20,0,20,0,20,0,0,0,0
Chittagong,Noakhali,Begumganj,Begumganj,68,0,68,0,68,0,0,0,0
Chittagong,Noakhali,Begumganj,Durgapur,122,0,122,0,122,0,0,0,0
Chittagong,Noakhali,Begumganj,Hajipur,141,1,140,0,140,0,1,0,0
Chittagong,Noakhali,Begumganj,Eklashpur,154,0,154,0,154,0,0,0,0
Chittagong,Noakhali,Begumganj,Gopalpur,200,0,200,0,200,0,0,0,0
Chittagong,Noakhali,Begumganj,Jirtali,168,1,167,0,167,1,0,0,0
Chittagong,Noakhali,Begumganj,Kadirpur,97,1,96,0,96,1,0,0,0
Chittagong,Noakhali,Begumganj,Mir Warishpur,141,0,141,0,141,0,0,0,0
Chittagong,Noakhali,Begumganj,Narottampur,12,1,11,0,11,1,0,0,0
Chittagong,Noakhali,Begumganj,Rajganj,142,0,142,0,142,0,0,0,0
Chittagong,Noakhali,Begumganj,Sharifpur,130,0,130,0,130,0,0,0,0
Chittagong,Noakhali,Begumganj,###,2076,7,2069,0,2069,6,1,0,0
Chittagong,Noakhali,Senbagh,Kabilpur,19,1,18,0,18,1,0,0,0
Chittagong,Noakhali,Senbagh,Senbagh Paurashava,51,1,50,0,50,1,0,0,0
Chittagong,Noakhali,Senbagh,Kadra,21,0,21,0,21,0,0,0,0
Chittagong,Noakhali,Senbagh,Kesharpar,14,1,13,0,13,0,1,0,0
Chittagong,Noakhali,Senbagh,Dumuria,3,1,2,0,2,0,1,0,0
Chittagong,Noakhali,Senbagh,Arjuntala,6,0,6,0,6,0,0,0,0
Chittagong,Noakhali,Senbagh,Nabipur,5,1,4,0,4,1,0,0,0
Chittagong,Noakhali,Senbagh,Chhatarpaia,1,1,0,0,0,1,0,0,0
Chittagong,Noakhali,Senbagh,Mohammadpur,1,1,0,0,0,1,0,0,0
Chittagong,Noakhali,Senbagh,Bejoybagh,1,1,0,0,0,1,0,0,0
Chittagong,Noakhali,Senbagh,###,122,8,114,0,114,6,2,0,0
Chittagong,Noakhali,Chatkhil,Khil Para,16,1,15,0,15,1,0,0,0
Chittagong,Noakhali,Chatkhil,Chatkhil Paurashava,83,4,79,0,79,4,0,0,0
Chittagong,Noakhali,Chatkhil,Sahapur,9,1,8,0,8,1,0,0,0
Chittagong,Noakhali,Chatkhil,Panchgaon,12,3,9,0,9,3,0,0,0
Chittagong,Noakhali,Chatkhil,Ramnarayanpur,5,1,4,0,4,1,0,0,0
Chittagong,Noakhali,Chatkhil,Mohammadpur,4,1,3,0,3,0,1,0,0
Chittagong,Noakhali,Chatkhil,Badalkut,3,1,2,0,2,1,0,0,0
Chittagong,Noakhali,Chatkhil,Parkote,1,1,0,0,0,1,0,0,0
Chittagong,Noakhali,Chatkhil,Hatpukuria Ghatlabag,0,0,0,0,0,0,0,0,0
Chittagong,Noakhali,Chatkhil,Nayakhola,0,0,0,0,0,0,0,0,0
Chittagong,Noakhali,Chatkhil,###,133,13,120,0,120,12,1,0,0
Chittagong,Noakhali,Companiganj,Char Parbati,14,1,13,0,13,1,0,0,0
Chittagong,Noakhali,Companiganj,Rampur,50,1,49,0,49,1,0,0,0
Chittagong,Noakhali,Companiganj,Char Elahi,34,0,34,0,34,0,0,0,0
Chittagong,Noakhali,Companiganj,Char Fakira,73,1,72,0,72,1,0,0,0
Chittagong,Noakhali,Companiganj,Musapur,67,1,66,0,66,1,0,0,0
Chittagong,Noakhali,Companiganj,Char Hazari,1,1,0,0,0,1,0,0,0
Chittagong,Noakhali,Companiganj,Char Kakra,2,2,0,0,0,2,0,0,0
Chittagong,Noakhali,Companiganj,Basurhat Paurashava,0,0,0,0,0,0,0,0,0
Chittagong,Noakhali,Companiganj,Sirajpur,0,0,0,0,0,0,0,0,0
Chittagong,Noakhali,Companiganj,###,241,7,234,0,234,7,0,0,0
Chittagong,Noakhali,Subarnachar,Char Clerk,87,0,87,0,87,0,0,0,0
Chittagong,Noakhali,Subarnachar,Char Bata,83,1,82,0,82,1,0,0,0
Chittagong,Noakhali,Subarnachar,Char Amanullah,66,0,66,0,66,0,0,0,0
Chittagong,Noakhali,Subarnachar,Char Jubille,153,0,153,0,153,0,0,0,0
Chittagong,Noakhali,Subarnachar,Char Wapda,65,0,65,0,65,0,0,0,0
Chittagong,Noakhali,Subarnachar,Mohammadpur,2,0,2,0,2,0,0,0,0
Chittagong,Noakhali,Subarnachar,Char Jabbar,121,1,120,0,120,1,0,0,0
Chittagong,Noakhali,Subarnachar,Purba Char Bata,0,0,0,0,0,0,0,0,0
Chittagong,Noakhali,Subarnachar,###,577,2,575,0,575,2,0,0,0
Chittagong,Noakhali,Hatiya,Char Ishwar,165,0,165,0,165,0,0,0,0
Chittagong,Noakhali,Hatiya,Hatiya Paurashava,103,0,103,0,103,0,0,0,0
Chittagong,Noakhali,Hatiya,Tamaruddin,122,0,122,0,122,0,0,0,0
Chittagong,Noakhali,Hatiya,Burir Char,112,0,112,0,112,0,0,0,0
Chittagong,Noakhali,Hatiya,Jahajmara,124,0,124,0,124,0,0,0,0
Chittagong,Noakhali,Hatiya,Nalchira,6,0,6,0,6,0,0,0,0
Chittagong,Noakhali,Hatiya,Sonadia,50,0,50,0,50,0,0,0,0
Chittagong,Noakhali,Hatiya,Harni,3,0,3,0,3,0,0,0,0
Chittagong,Noakhali,Hatiya,Sukh Char,18,0,18,0,18,0,0,0,0
Chittagong,Noakhali,Hatiya,Nijum Dip,12,0,12,0,12,0,0,0,0
Chittagong,Noakhali,Hatiya,Chandnandi,22,0,22,0,22,0,0,0,0
Chittagong,Noakhali,Hatiya,Char King,0,0,0,0,0,0,0,0,0
Chittagong,Noakhali,Hatiya,###,737,0,737,0,737,0,0,0,0
Chittagong,Noakhali,###,###,6011,49,5962,0,5962,44,5,0,0
Chittagong,Khagrachhari,Matiranga,Belchhari,1,0,1,0,1,0,0,0,0
Chittagong,Khagrachhari,Matiranga,Beimar,1,0,1,0,1,0,0,0,0
Chittagong,Khagrachhari,Matiranga,Amtali,0,0,0,0,0,0,0,0,0
Chittagong,Khagrachhari,Matiranga,Baranala,0,0,0,0,0,0,0,0,0
Chittagong,Khagrachhari,Matiranga,Gumti,0,0,0,0,0,0,0,0,0
Chittagong,Khagrachhari,Matiranga,Matiranga,0,0,0,0,0,0,0,0,0
Chittagong,Khagrachhari,Matiranga,Matiranga Paurashava,0,0,0,0,0,0,0,0,0
Chittagong,Khagrachhari,Matiranga,Taindang,0,0,0,0,0,0,0,0,0
Chittagong,Khagrachhari,Matiranga,Tubalchhari,0,0,0,0,0,0,0,0,0
Chittagong,Khagrachhari,Matiranga,###,2,0,2,0,2,0,0,0,0
Chittagong,Khagrachhari,Mahalchhari,Mahalchhari,2,0,2,0,2,0,0,0,0
Chittagong,Khagrachhari,Mahalchhari,Maschhari,3,0,3,0,3,0,0,0,0
Chittagong,Khagrachhari,Mahalchhari,Sindukchari,1,0,1,0,1,0,0,0,0
Chittagong,Khagrachhari,Mahalchhari,Kayangghat,0,0,0,0,0,0,0,0,0
Chittagong,Khagrachhari,Mahalchhari,Mubachhari,0,0,0,0,0,0,0,0,0
Chittagong,Khagrachhari,Mahalchhari,###,6,0,6,0,6,0,0,0,0
Chittagong,Khagrachhari,Lakshmichhari,Dulyatali,2,0,2,0,2,0,0,0,0
Chittagong,Khagrachhari,Lakshmichhari,Barmachhari,0,0,0,0,0,0,0,0,0
Chittagong,Khagrachhari,Lakshmichhari,Lakshmichhari,0,0,0,0,0,0,0,0,0
Chittagong,Khagrachhari,Lakshmichhari,###,2,0,2,0,2,0,0,0,0
Chittagong,Khagrachhari,Dighinala,Dighinala,2,0,2,0,2,0,0,0,0
Chittagong,Khagrachhari,Dighinala,Babuchhara,0,0,0,0,0,0,0,0,0
Chittagong,Khagrachhari,Dighinala,Boalkhali,0,0,0,0,0,0,0,0,0
Chittagong,Khagrachhari,Dighinala,Kabakhali,0,0,0,0,0,0,0,0,0
Chittagong,Khagrachhari,Dighinala,Merung,0,0,0,0,0,0,0,0,0
Chittagong,Khagrachhari,Dighinala,###,2,0,2,0,2,0,0,0,0
Chittagong,Khagrachhari,Manikchhari,Batnatali,0,0,0,0,0,0,0,0,0
Chittagong,Khagrachhari,Manikchhari,Juggachhala,0,0,0,0,0,0,0,0,0
Chittagong,Khagrachhari,Manikchhari,Manikchhari,0,0,0,0,0,0,0,0,0
Chittagong,Khagrachhari,Manikchhari,Tintahari,0,0,0,0,0,0,0,0,0
Chittagong,Khagrachhari,Manikchhari,###,0,0,0,0,0,0,0,0,0
Chittagong,Khagrachhari,Khagrachhari Sadar,Bhaibonchhara,0,0,0,0,0,0,0,0,0
Chittagong,Khagrachhari,Khagrachhari Sadar,Golabari,0,0,0,0,0,0,0,0,0
Chittagong,Khagrachhari,Khagrachhari Sadar,Kamalchhari,0,0,0,0,0,0,0,0,0
Chittagong,Khagrachhari,Khagrachhari Sadar,Khagrachhari,0,0,0,0,0,0,0,0,0
Chittagong,Khagrachhari,Khagrachhari Sadar,Khagrachhari Paurashava,0,0,0,0,0,0,0,0,0
Chittagong,Khagrachhari,Khagrachhari Sadar,Perachhara,0,0,0,0,0,0,0,0,0
Chittagong,Khagrachhari,Khagrachhari Sadar,###,0,0,0,0,0,0,0,0,0
Chittagong,Khagrachhari,Panchhari,Chengi,0,0,0,0,0,0,0,0,0
Chittagong,Khagrachhari,Panchhari,Latiban,0,0,0,0,0,0,0,0,0
Chittagong,Khagrachhari,Panchhari,Logang,0,0,0,0,0,0,0,0,0
Chittagong,Khagrachhari,Panchhari,Panchhari,0,0,0,0,0,0,0,0,0
Chittagong,Khagrachhari,Panchhari,Ulta Chari,0,0,0,0,0,0,0,0,0
Chittagong,Khagrachhari,Panchhari,###,0,0,0,0,0,0,0,0,0
Chittagong,Khagrachhari,Ramgarh,Hapchhari,0,0,0,0,0,0,0,0,0
Chittagong,Khagrachhari,Ramgarh,Pathachhara,0,0,0,0,0,0,0,0,0
Chittagong,Khagrachhari,Ramgarh,Ramgarh,0,0,0,0,0,0,0,0,0
Chittagong,Khagrachhari,Ramgarh,Ramgarh Paurashava,0,0,0,0,0,0,0,0,0
Chittagong,Khagrachhari,Ramgarh,###,0,0,0,0,0,0,0,0,0
Chittagong,Khagrachhari,###,###,12,0,12,0,12,0,0,0,0
Chittagong,Feni,Daganbhuiyan,Mathu Bhuiyan,12,0,12,0,12,0,0,0,0
Chittagong,Feni,Daganbhuiyan,Daganbhuiyan,29,0,29,0,29,0,0,0,0
Chittagong,Feni,Daganbhuiyan,Daganbhuiyan Paurashava,5,2,3,0,3,2,0,0,0
Chittagong,Feni,Daganbhuiyan,Purba Chandrapur,1,1,0,0,0,1,0,0,0
Chittagong,Feni,Daganbhuiyan,Jailashkara,2,1,1,0,1,0,1,0,0
Chittagong,Feni,Daganbhuiyan,Sindurpur,1,1,0,0,0,0,1,0,0
Chittagong,Feni,Daganbhuiyan,Yakubpur,1,1,0,0,0,0,1,0,0
Chittagong,Feni,Daganbhuiyan,Rajapur,1,1,0,0,0,0,1,0,0
Chittagong,Feni,Daganbhuiyan,Ramnagar,0,0,0,0,0,0,0,0,0
Chittagong,Feni,Daganbhuiyan,###,52,7,45,0,45,3,4,0,0
Chittagong,Feni,Feni Sadar,Feni Paurashava,93,1,92,0,92,0,1,0,0
Chittagong,Feni,Feni Sadar,Kazirbag,16,2,14,0,14,0,1,1,0
Chittagong,Feni,Feni Sadar,Dharmapur,27,1,26,0,26,0,1,0,0
Chittagong,Feni,Feni Sadar,Kalidah,7,0,7,0,7,0,0,0,0
Chittagong,Feni,Feni Sadar,Baligaon,3,0,3,0,3,0,0,0,0
Chittagong,Feni,Feni Sadar,Lemua,11,1,10,0,10,1,0,0,0
Chittagong,Feni,Feni Sadar,Panchgachhiya,7,1,6,0,6,0,1,0,0
Chittagong,Feni,Feni Sadar,Fazilpur,2,1,1,0,1,0,1,0,0
Chittagong,Feni,Feni Sadar,Dhalia,6,1,5,0,5,0,1,0,0
Chittagong,Feni,Feni Sadar,Sarishadi,1,1,0,0,0,0,1,0,0
Chittagong,Feni,Feni Sadar,Matabi,2,0,2,0,2,0,0,0,0
Chittagong,Feni,Feni Sadar,Farhadnagar,0,0,0,0,0,0,0,0,0
Chittagong,Feni,Feni Sadar,Sanua,0,0,0,0,0,0,0,0,0
Chittagong,Feni,Feni Sadar,###,175,9,166,0,166,1,7,1,0
Chittagong,Feni,Chhagalnaiya,Chhagalnaiya Paurashava,22,1,21,0,21,0,1,0,0
Chittagong,Feni,Chhagalnaiya,Radhanagar,3,1,2,0,2,0,0,1,0
Chittagong,Feni,Chhagalnaiya,Subhapur,7,1,6,0,6,0,1,0,0
Chittagong,Feni,Chhagalnaiya,Gopal,3,1,2,0,2,0,1,0,0
Chittagong,Feni,Chhagalnaiya,Pathannagar,5,1,4,1,3,0,1,0,0
Chittagong,Feni,Chhagalnaiya,Mohamaya,3,2,1,0,1,0,2,0,0
Chittagong,Feni,Chhagalnaiya,###,43,7,36,1,35,0,6,1,0
Chittagong,Feni,Fulgazi,Munshirhat,2,0,2,0,2,0,0,0,0
Chittagong,Feni,Fulgazi,Fulgazi,6,1,5,0,5,0,1,0,0
Chittagong,Feni,Fulgazi,Darbarpur,6,1,5,0,5,0,1,0,0
Chittagong,Feni,Fulgazi,Amjadhat,2,2,0,0,0,0,0,2,0
Chittagong,Feni,Fulgazi,Anandapur,1,1,0,0,0,0,1,0,0
Chittagong,Feni,Fulgazi,G.M.Hat,0,0,0,0,0,0,0,0,0
Chittagong,Feni,Fulgazi,###,17,5,12,0,12,0,3,2,0
Chittagong,Feni,Sonagazi,Mangalkandi,34,1,33,0,33,1,0,0,0
Chittagong,Feni,Sonagazi,Sonagazi Paurashava,154,2,152,0,152,2,0,0,0
Chittagong,Feni,Sonagazi,Sonagazi,61,0,61,0,61,0,0,0,0
Chittagong,Feni,Sonagazi,Amirabad,121,2,119,0,119,1,1,0,0
Chittagong,Feni,Sonagazi,Nawabpur,28,1,27,0,27,1,0,0,0
Chittagong,Feni,Sonagazi,Char Darbesh,128,1,127,0,127,1,0,0,0
Chittagong,Feni,Sonagazi,Char Chandia,4,0,4,0,4,0,0,0,0
Chittagong,Feni,Sonagazi,Matiganj,39,1,38,0,38,1,0,0,0
Chittagong,Feni,Sonagazi,Bagadana,52,1,51,0,51,0,1,0,0
Chittagong,Feni,Sonagazi,Char Majlishpur,41,2,39,0,39,1,1,0,0
Chittagong,Feni,Sonagazi,###,662,11,651,0,651,8,3,0,0
Chittagong,Feni,Parshuram,Parshuram Paurashava,24,2,22,0,22,0,2,0,0
Chittagong,Feni,Parshuram,Mirzanagar,2,1,1,0,1,0,1,0,0
Chittagong,Feni,Parshuram,Baksh Mohammad,3,2,1,0,1,0,2,0,0
Chittagong,Feni,Parshuram,Chithalia,1,1,0,0,0,0,1,0,0
Chittagong,Feni,Parshuram,###,30,6,24,0,24,0,6,0,0
Chittagong,Feni,###,###,979,45,934,1,933,12,29,4,0
Chittagong,Rangamati,Kawkhali (Betbunia),Fatik Chhari,1,0,1,0,1,0,0,0,0
Chittagong,Rangamati,Kawkhali (Betbunia),Ghagra,2,0,2,0,2,0,0,0,0
Chittagong,Rangamati,Kawkhali (Betbunia),Betbunia,0,0,0,0,0,0,0,0,0
Chittagong,Rangamati,Kawkhali (Betbunia),Kalampati,0,0,0,0,0,0,0,0,0
Chittagong,Rangamati,Kawkhali (Betbunia),###,3,0,3,0,3,0,0,0,0
Chittagong,Rangamati,Langadu,Adrarak Chara,0,0,0,0,0,0,0,0,0
Chittagong,Rangamati,Langadu,Bhasanya Adam,0,0,0,0,0,0,0,0,0
Chittagong,Rangamati,Langadu,Bogachatar,0,0,0,0,0,0,0,0,0
Chittagong,Rangamati,Langadu,Gulshakhali,0,0,0,0,0,0,0,0,0
Chittagong,Rangamati,Langadu,Kalapakurjya,0,0,0,0,0,0,0,0,0
Chittagong,Rangamati,Langadu,Langadu,0,0,0,0,0,0,0,0,0
Chittagong,Rangamati,Langadu,Mayanimukh,0,0,0,0,0,0,0,0,0
Chittagong,Rangamati,Langadu,###,0,0,0,0,0,0,0,0,0
Chittagong,Rangamati,Barkal,Aiba Chhara,0,0,0,0,0,0,0,0,0
Chittagong,Rangamati,Barkal,Bara Harina,0,0,0,0,0,0,0,0,0
Chittagong,Rangamati,Barkal,Barkal,0,0,0,0,0,0,0,0,0
Chittagong,Rangamati,Barkal,Bhushan Chhara,0,0,0,0,0,0,0,0,0
Chittagong,Rangamati,Barkal,Shublong,0,0,0,0,0,0,0,0,0
Chittagong,Rangamati,Barkal,###,0,0,0,0,0,0,0,0,0
Chittagong,Rangamati,Baghai Chhari,Amtali,0,0,0,0,0,0,0,0,0
Chittagong,Rangamati,Baghai Chhari,Baghai Chhari,0,0,0,0,0,0,0,0,0
Chittagong,Rangamati,Baghai Chhari,Baghaichhari Paurashava,0,0,0,0,0,0,0,0,0
Chittagong,Rangamati,Baghai Chhari,Bangaltali,0,0,0,0,0,0,0,0,0
Chittagong,Rangamati,Baghai Chhari,Kedarmara,0,0,0,0,0,0,0,0,0
Chittagong,Rangamati,Baghai Chhari,Marishya,0,0,0,0,0,0,0,0,0
Chittagong,Rangamati,Baghai Chhari,Rupakari,0,0,0,0,0,0,0,0,0
Chittagong,Rangamati,Baghai Chhari,Sajek,0,0,0,0,0,0,0,0,0
Chittagong,Rangamati,Baghai Chhari,Sarboatali,0,0,0,0,0,0,0,0,0
Chittagong,Rangamati,Baghai Chhari,###,0,0,0,0,0,0,0,0,0
Chittagong,Rangamati,Rangamati Sadar,Balukhali,0,0,0,0,0,0,0,0,0
Chittagong,Rangamati,Rangamati Sadar,Banduk Bhanga,0,0,0,0,0,0,0,0,0
Chittagong,Rangamati,Rangamati Sadar,Jibtali,0,0,0,0,0,0,0,0,0
Chittagong,Rangamati,Rangamati Sadar,Kutuk Chhari,0,0,0,0,0,0,0,0,0
Chittagong,Rangamati,Rangamati Sadar,Magban,0,0,0,0,0,0,0,0,0
Chittagong,Rangamati,Rangamati Sadar,Rangamati Paurashava,0,0,0,0,0,0,0,0,0
Chittagong,Rangamati,Rangamati Sadar,Sapchhari,0,0,0,0,0,0,0,0,0
Chittagong,Rangamati,Rangamati Sadar,###,0,0,0,0,0,0,0,0,0
Chittagong,Rangamati,Rajasthali,Bangalhalia,0,0,0,0,0,0,0,0,0
Chittagong,Rangamati,Rajasthali,Gainda,0,0,0,0,0,0,0,0,0
Chittagong,Rangamati,Rajasthali,Ghila Chhari,0,0,0,0,0,0,0,0,0
Chittagong,Rangamati,Rajasthali,###,0,0,0,0,0,0,0,0,0
Chittagong,Rangamati,Jurai Chhari,Banjugi Chhara,0,0,0,0,0,0,0,0,0
Chittagong,Rangamati,Jurai Chhari,Dumdumya,0,0,0,0,0,0,0,0,0
Chittagong,Rangamati,Jurai Chhari,Jurai Chhari,0,0,0,0,0,0,0,0,0
Chittagong,Rangamati,Jurai Chhari,Maidang,0,0,0,0,0,0,0,0,0
Chittagong,Rangamati,Jurai Chhari,###,0,0,0,0,0,0,0,0,0
Chittagong,Rangamati,Belai Chhari,Belai Chhari,0,0,0,0,0,0,0,0,0
Chittagong,Rangamati,Belai Chhari,Farua,0,0,0,0,0,0,0,0,0
Chittagong,Rangamati,Belai Chhari,Kangara Chhari,0,0,0,0,0,0,0,0,0
Chittagong,Rangamati,Belai Chhari,###,0,0,0,0,0,0,0,0,0
Chittagong,Rangamati,Naniarchar,Burighat,0,0,0,0,0,0,0,0,0
Chittagong,Rangamati,Naniarchar,Ghila Chhari,0,0,0,0,0,0,0,0,0
Chittagong,Rangamati,Naniarchar,Naniarchar,0,0,0,0,0,0,0,0,0
Chittagong,Rangamati,Naniarchar,Sabekhyong,0,0,0,0,0,0,0,0,0
Chittagong,Rangamati,Naniarchar,###,0,0,0,0,0,0,0,0,0
Chittagong,Rangamati,Kaptai,Chandraghona,0,0,0,0,0,0,0,0,0
Chittagong,Rangamati,Kaptai,Chitmaram,0,0,0,0,0,0,0,0,0
Chittagong,Rangamati,Kaptai,Kaptai,0,0,0,0,0,0,0,0,0
Chittagong,Rangamati,Kaptai,Raikhali,0,0,0,0,0,0,0,0,0
Chittagong,Rangamati,Kaptai,Wagga,0,0,0,0,0,0,0,0,0
Chittagong,Rangamati,Kaptai,###,0,0,0,0,0,0,0,0,0
Chittagong,Rangamati,###,###,3,0,3,0,3,0,0,0,0
Chittagong,Chittagong,Sandwip,Kalapania,1,0,1,0,1,0,0,0,0
Chittagong,Chittagong,Sandwip,Urirchar,2,0,2,0,2,0,0,0,0
Chittagong,Chittagong,Sandwip,Amanullah,0,0,0,0,0,0,0,0,0
Chittagong,Chittagong,Sandwip,Azimpur,0,0,0,0,0,0,0,0,0
Chittagong,Chittagong,Sandwip,Bauria,0,0,0,0,0,0,0,0,0
Chittagong,Chittagong,Sandwip,Digghapar,0,0,0,0,0,0,0,0,0
Chittagong,Chittagong,Sandwip,Gachhua,0,0,0,0,0,0,0,0,0
Chittagong,Chittagong,Sandwip,Haramia,0,0,0,0,0,0,0,0,0
Chittagong,Chittagong,Sandwip,Harispur,0,0,0,0,0,0,0,0,0
Chittagong,Chittagong,Sandwip,Magdhara,0,0,0,0,0,0,0,0,0
Chittagong,Chittagong,Sandwip,Maitbhanga,0,0,0,0,0,0,0,0,0
Chittagong,Chittagong,Sandwip,Musapur,0,0,0,0,0,0,0,0,0
Chittagong,Chittagong,Sandwip,Rahmatpur,0,0,0,0,0,0,0,0,0
Chittagong,Chittagong,Sandwip,Sandwip Paurashava,0,0,0,0,0,0,0,0,0
Chittagong,Chittagong,Sandwip,Santoshpur,0,0,0,0,0,0,0,0,0
Chittagong,Chittagong,Sandwip,Sarikait,0,0,0,0,0,0,0,0,0
Chittagong,Chittagong,Sandwip,###,3,0,3,0,3,0,0,0,0
Chittagong,Chittagong,Fatikchhari,Lelang,1,0,1,0,1,0,0,0,0
Chittagong,Chittagong,Fatikchhari,Abdullapur,0,0,0,0,0,0,0,0,0
Chittagong,Chittagong,Fatikchhari,Bagan Bazar,0,0,0,0,0,0,0,0,0
Chittagong,Chittagong,Fatikchhari,Baktapur,0,0,0,0,0,0,0,0,0
Chittagong,Chittagong,Fatikchhari,Bhujpur,0,0,0,0,0,0,0,0,0
Chittagong,Chittagong,Fatikchhari,Dantmara,0,0,0,0,0,0,0,0,0
Chittagong,Chittagong,Fatikchhari,Daulatpur,0,0,0,0,0,0,0,0,0
Chittagong,Chittagong,Fatikchhari,Dharmapur,0,0,0,0,0,0,0,0,0
Chittagong,Chittagong,Fatikchhari,Dhurung,0,0,0,0,0,0,0,0,0
Chittagong,Chittagong,Fatikchhari,Harwalchhari,0,0,0,0,0,0,0,0,0
Chittagong,Chittagong,Fatikchhari,Jafarnagar,0,0,0,0,0,0,0,0,0
Chittagong,Chittagong,Fatikchhari,Kanchan Nagar,0,0,0,0,0,0,0,0,0
Chittagong,Chittagong,Fatikchhari,Khiram,0,0,0,0,0,0,0,0,0
Chittagong,Chittagong,Fatikchhari,Nanupur,0,0,0,0,0,0,0,0,0
Chittagong,Chittagong,Fatikchhari,Narayanhat,0,0,0,0,0,0,0,0,0
Chittagong,Chittagong,Fatikchhari,Paindanga,0,0,0,0,0,0,0,0,0
Chittagong,Chittagong,Fatikchhari,Rangamatia,0,0,0,0,0,0,0,0,0
Chittagong,Chittagong,Fatikchhari,Roushangiri,0,0,0,0,0,0,0,0,0
Chittagong,Chittagong,Fatikchhari,Samitirhat,0,0,0,0,0,0,0,0,0
Chittagong,Chittagong,Fatikchhari,Suabil,0,0,0,0,0,0,0,0,0
Chittagong,Chittagong,Fatikchhari,Sundarpur,0,0,0,0,0,0,0,0,0
Chittagong,Chittagong,Fatikchhari,###,1,0,1,0,1,0,0,0,0
Chittagong,Chittagong,Raozan,Dabua,1,0,1,0,1,0,0,0,0
Chittagong,Chittagong,Raozan,Bagoan,0,0,0,0,0,0,0,0,0
Chittagong,Chittagong,Raozan,Binajuri,0,0,0,0,0,0,0,0,0
Chittagong,Chittagong,Raozan,Chikdair,0,0,0,0,0,0,0,0,0
Chittagong,Chittagong,Raozan,Gahira,0,0,0,0,0,0,0,0,0
Chittagong,Chittagong,Raozan,Haladia,0,0,0,0,0,0,0,0,0
Chittagong,Chittagong,Raozan,Kadalpur,0,0,0,0,0,0,0,0,0
Chittagong,Chittagong,Raozan,Noa Para,0,0,0,0,0,0,0,0,0
Chittagong,Chittagong,Raozan,Noajispur,0,0,0,0,0,0,0,0,0
Chittagong,Chittagong,Raozan,Pahartali,0,0,0,0,0,0,0,0,0
Chittagong,Chittagong,Raozan,Paschim Guzara,0,0,0,0,0,0,0,0,0
Chittagong,Chittagong,Raozan,Purba Guzara,0,0,0,0,0,0,0,0,0
Chittagong,Chittagong,Raozan,Raozan,0,0,0,0,0,0,0,0,0
Chittagong,Chittagong,Raozan,Raozan Paurashava,0,0,0,0,0,0,0,0,0
Chittagong,Chittagong,Raozan,Urkirchar,0,0,0,0,0,0,0,0,0
Chittagong,Chittagong,Raozan,###,1,0,1,0,1,0,0,0,0
Chittagong,Chittagong,Sitakunda,Saidpur,1,0,1,0,1,0,0,0,0
Chittagong,Chittagong,Sitakunda,Salimpur,1,1,0,0,0,0,1,0,0
Chittagong,Chittagong,Sitakunda,Bhatiari,1,1,0,0,0,0,1,0,0
Chittagong,Chittagong,Sitakunda,Kumira,1,1,0,0,0,1,0,0,0
Chittagong,Chittagong,Sitakunda,Muradpur,1,0,1,1,0,0,0,0,0
Chittagong,Chittagong,Sitakunda,Barabkunda,1,1,0,0,0,1,0,0,0
Chittagong,Chittagong,Sitakunda,Banshbaria,1,1,0,0,0,0,1,0,0
Chittagong,Chittagong,Sitakunda,Sitakunda Paurashava,3,1,2,0,2,0,1,0,0
Chittagong,Chittagong,Sitakunda,Bariadyala,1,1,0,0,0,1,0,0,0
Chittagong,Chittagong,Sitakunda,Sonaichhari,0,0,0,0,0,0,0,0,0
Chittagong,Chittagong,Sitakunda,###,11,7,4,1,3,3,4,0,0
Chittagong,Chittagong,Boalkhali,Saroatali,3,0,3,0,3,0,0,0,0
Chittagong,Chittagong,Boalkhali,Ahla Karaldanga,0,0,0,0,0,0,0,0,0
Chittagong,Chittagong,Boalkhali,Amchia,0,0,0,0,0,0,0,0,0
Chittagong,Chittagong,Boalkhali,Charandwip,0,0,0,0,0,0,0,0,0
Chittagong,Chittagong,Boalkhali,Kandhurkhil,0,0,0,0,0,0,0,0,0
Chittagong,Chittagong,Boalkhali,Paschim Gomdandi,0,0,0,0,0,0,0,0,0
Chittagong,Chittagong,Boalkhali,Popadia,0,0,0,0,0,0,0,0,0
Chittagong,Chittagong,Boalkhali,Purba Gomdandi,0,0,0,0,0,0,0,0,0
Chittagong,Chittagong,Boalkhali,Sakpura,0,0,0,0,0,0,0,0,0
Chittagong,Chittagong,Boalkhali,Sreepur Kharandwip,0,0,0,0,0,0,0,0,0
Chittagong,Chittagong,Boalkhali,###,3,0,3,0,3,0,0,0,0
Chittagong,Chittagong,Banshkhali,Sadhanpur,2,1,1,0,1,0,0,1,0
Chittagong,Chittagong,Banshkhali,Katharia,2,0,2,0,2,0,0,0,0
Chittagong,Chittagong,Banshkhali,Bailchhari,3,1,2,0,2,0,0,1,0
Chittagong,Chittagong,Banshkhali,Banshkhali Paurashava,3,1,2,0,2,0,0,1,0
Chittagong,Chittagong,Banshkhali,Kalipur,1,1,0,0,0,0,1,0,0
Chittagong,Chittagong,Banshkhali,Chambal,2,0,2,0,2,0,0,0,0
Chittagong,Chittagong,Banshkhali,Baharchhara,0,0,0,0,0,0,0,0,0
Chittagong,Chittagong,Banshkhali,Chhanua,0,0,0,0,0,0,0,0,0
Chittagong,Chittagong,Banshkhali,Gandamara,0,0,0,0,0,0,0,0,0
Chittagong,Chittagong,Banshkhali,Khankhanabad,0,0,0,0,0,0,0,0,0
Chittagong,Chittagong,Banshkhali,Puichhari,0,0,0,0,0,0,0,0,0
Chittagong,Chittagong,Banshkhali,Pukuria,0,0,0,0,0,0,0,0,0
Chittagong,Chittagong,Banshkhali,Saral,0,0,0,0,0,0,0,0,0
Chittagong,Chittagong,Banshkhali,Sekherkhil,0,0,0,0,0,0,0,0,0
Chittagong,Chittagong,Banshkhali,Silkup,0,0,0,0,0,0,0,0,0
Chittagong,Chittagong,Banshkhali,###,13,4,9,0,9,0,1,3,0
Chittagong,Chittagong,Patiya,Kasiais,1,0,1,0,1,0,0,0,0
Chittagong,Chittagong,Patiya,Kusumpura,1,0,1,0,1,0,0,0,0
Chittagong,Chittagong,Patiya,Sobhandandi,1,0,1,0,1,0,0,0,0
Chittagong,Chittagong,Patiya,Asia,0,0,0,0,0,0,0,0,0
Chittagong,Chittagong,Patiya,Bara Uthan,0,0,0,0,0,0,0,0,0
Chittagong,Chittagong,Patiya,Baralia,0,0,0,0,0,0,0,0,0
Chittagong,Chittagong,Patiya,Bhatikhain,0,0,0,0,0,0,0,0,0
Chittagong,Chittagong,Patiya,Chanhara,0,0,0,0,0,0,0,0,0
Chittagong,Chittagong,Patiya,Char Lakshya,0,0,0,0,0,0,0,0,0
Chittagong,Chittagong,Patiya,Char Patharghata,0,0,0,0,0,0,0,0,0
Chittagong,Chittagong,Patiya,Dakhin D.bhurshi,0,0,0,0,0,0,0,0,0
Chittagong,Chittagong,Patiya,Dhalghat,0,0,0,0,0,0,0,0,0
Chittagong,Chittagong,Patiya,Habilas Dwip,0,0,0,0,0,0,0,0,0
Chittagong,Chittagong,Patiya,Haidgaon,0,0,0,0,0,0,0,0,0
Chittagong,Chittagong,Patiya,Janglukhain,0,0,0,0,0,0,0,0,0
Chittagong,Chittagong,Patiya,Jiri,0,0,0,0,0,0,0,0,0
Chittagong,Chittagong,Patiya,Juldha,0,0,0,0,0,0,0,0,0
Chittagong,Chittagong,Patiya,Kachuai,0,0,0,0,0,0,0,0,0
Chittagong,Chittagong,Patiya,Kelishahar,0,0,0,0,0,0,0,0,0
Chittagong,Chittagong,Patiya,Kharana,0,0,0,0,0,0,0,0,0
Chittagong,Chittagong,Patiya,Kolagaon,0,0,0,0,0,0,0,0,0
Chittagong,Chittagong,Patiya,Patiya Paurashava,0,0,0,0,0,0,0,0,0
Chittagong,Chittagong,Patiya,Sikalbaha,0,0,0,0,0,0,0,0,0
Chittagong,Chittagong,Patiya,###,3,0,3,0,3,0,0,0,0
Chittagong,Chittagong,Anowara,Barakhain,3,1,2,0,2,0,0,1,0
Chittagong,Chittagong,Anowara,Paraikora,2,0,2,0,2,0,0,0,0
Chittagong,Chittagong,Anowara,Battali,1,1,0,0,0,0,1,0,0
Chittagong,Chittagong,Anowara,Barasat,2,2,0,0,0,0,1,1,0
Chittagong,Chittagong,Anowara,Roypur,1,1,0,0,0,1,0,0,0
Chittagong,Chittagong,Anowara,Haildhar,1,1,0,0,0,0,1,0,0
Chittagong,Chittagong,Anowara,Anowara,1,1,0,0,0,0,1,0,0
Chittagong,Chittagong,Anowara,Bairag,2,0,2,0,2,0,0,0,0
Chittagong,Chittagong,Anowara,Burumchhara,0,0,0,0,0,0,0,0,0
Chittagong,Chittagong,Anowara,Chatari,0,0,0,0,0,0,0,0,0
Chittagong,Chittagong,Anowara,Juidandi,0,0,0,0,0,0,0,0,0
Chittagong,Chittagong,Anowara,###,13,7,6,0,6,1,4,2,0
Chittagong,Chittagong,Chandgaon,Ward No-05,1,1,0,0,0,0,1,0,0
Chittagong,Chittagong,Chandgaon,Ward No-06,1,1,0,0,0,0,0,1,0
Chittagong,Chittagong,Chandgaon,Ward No-04,3,0,3,0,3,0,0,0,0
Chittagong,Chittagong,Chandgaon,###,5,2,3,0,3,0,1,1,0
Chittagong,Chittagong,Mirsharai,Dhum,1,1,0,0,0,0,1,0,0
Chittagong,Chittagong,Mirsharai,Baroiar Hat Paurashava,2,0,2,0,2,0,0,0,0
Chittagong,Chittagong,Mirsharai,Karerhat,1,1,0,0,0,0,1,0,0
Chittagong,Chittagong,Mirsharai,Wahedpur,1,1,0,0,0,1,0,0,0
Chittagong,Chittagong,Mirsharai,Khaiyachhara,2,1,1,0,1,1,0,0,0
Chittagong,Chittagong,Mirsharai,Mirsharai,1,1,0,0,0,1,0,0,0
Chittagong,Chittagong,Mirsharai,Durgapur,1,1,0,0,0,0,1,0,0
Chittagong,Chittagong,Mirsharai,Mithanala,2,0,2,0,2,0,0,0,0
Chittagong,Chittagong,Mirsharai,Haitkandi,0,0,0,0,0,0,0,0,0
Chittagong,Chittagong,Mirsharai,Hinguli,0,0,0,0,0,0,0,0,0
Chittagong,Chittagong,Mirsharai,Ichhakhali,0,0,0,0,0,0,0,0,0
Chittagong,Chittagong,Mirsharai,Katachhara,0,0,0,0,0,0,0,0,0
Chittagong,Chittagong,Mirsharai,Maghadia,0,0,0,0,0,0,0,0,0
Chittagong,Chittagong,Mirsharai,Mayani,0,0,0,0,0,0,0,0,0
Chittagong,Chittagong,Mirsharai,Mirsharai Paurashava,0,0,0,0,0,0,0,0,0
Chittagong,Chittagong,Mirsharai,Osmanpur,0,0,0,0,0,0,0,0,0
Chittagong,Chittagong,Mirsharai,Saherkhali,0,0,0,0,0,0,0,0,0
Chittagong,Chittagong,Mirsharai,Zorwarganj,0,0,0,0,0,0,0,0,0
Chittagong,Chittagong,Mirsharai,###,11,6,5,0,5,3,3,0,0
Chittagong,Chittagong,Kotwali,Ward No-31,1,1,0,0,0,1,0,0,0
Chittagong,Chittagong,Kotwali,Ward No-21,1,1,0,0,0,0,0,1,0
Chittagong,Chittagong,Kotwali,Ward No-15 (Part),0,0,0,0,0,0,0,0,0
Chittagong,Chittagong,Kotwali,Ward No-16,0,0,0,0,0,0,0,0,0
Chittagong,Chittagong,Kotwali,Ward No-20,0,0,0,0,0,0,0,0,0
Chittagong,Chittagong,Kotwali,Ward No-22,0,0,0,0,0,0,0,0,0
Chittagong,Chittagong,Kotwali,Ward No-30 (Part),0,0,0,0,0,0,0,0,0
Chittagong,Chittagong,Kotwali,Ward No-32,0,0,0,0,0,0,0,0,0
Chittagong,Chittagong,Kotwali,Ward No-33,0,0,0,0,0,0,0,0,0
Chittagong,Chittagong,Kotwali,Ward No-34,0,0,0,0,0,0,0,0,0
Chittagong,Chittagong,Kotwali,Ward No-35 (part),0,0,0,0,0,0,0,0,0
Chittagong,Chittagong,Kotwali,###,2,2,0,0,0,1,0,1,0
Chittagong,Chittagong,Double Mooring,Ward No-28,1,1,0,0,0,0,1,0,0
Chittagong,Chittagong,Double Mooring,Ward No-12 (Part),3,1,2,0,2,0,0,1,0
Chittagong,Chittagong,Double Mooring,Ward No-23,0,0,0,0,0,0,0,0,0
Chittagong,Chittagong,Double Mooring,Ward No-24 (part),0,0,0,0,0,0,0,0,0
Chittagong,Chittagong,Double Mooring,Ward No-27,0,0,0,0,0,0,0,0,0
Chittagong,Chittagong,Double Mooring,Ward No-29,0,0,0,0,0,0,0,0,0
Chittagong,Chittagong,Double Mooring,Ward No-30 (Part),0,0,0,0,0,0,0,0,0
Chittagong,Chittagong,Double Mooring,Ward No-36 (Part),0,0,0,0,0,0,0,0,0
Chittagong,Chittagong,Double Mooring,###,4,2,2,0,2,0,1,1,0
Chittagong,Chittagong,Panchlaish,Ward No-08 (part),1,1,0,0,0,1,0,0,0
Chittagong,Chittagong,Panchlaish,Ward No-07,0,0,0,0,0,0,0,0,0
Chittagong,Chittagong,Panchlaish,Ward No-15 (Part),0,0,0,0,0,0,0,0,0
Chittagong,Chittagong,Panchlaish,###,1,1,0,0,0,1,0,0,0
Chittagong,Chittagong,Khulshi,Ward No-13,1,1,0,0,0,0,0,1,0
Chittagong,Chittagong,Khulshi,Ward No-08 (part),0,0,0,0,0,0,0,0,0
Chittagong,Chittagong,Khulshi,Ward No-09 (Part),0,0,0,0,0,0,0,0,0
Chittagong,Chittagong,Khulshi,Ward No-14,0,0,0,0,0,0,0,0,0
Chittagong,Chittagong,Khulshi,###,1,1,0,0,0,0,0,1,0
Chittagong,Chittagong,Pahartali,Ward No-10,1,1,0,0,0,0,1,0,0
Chittagong,Chittagong,Pahartali,Ward No-09 (Part),0,0,0,0,0,0,0,0,0
Chittagong,Chittagong,Pahartali,Ward No-11 (Part),0,0,0,0,0,0,0,0,0
Chittagong,Chittagong,Pahartali,Ward No-12 (Part),0,0,0,0,0,0,0,0,0
Chittagong,Chittagong,Pahartali,###,1,1,0,0,0,0,1,0,0
Chittagong,Chittagong,Patenga,Ward No-39 (Part),1,1,0,0,0,0,1,0,0
Chittagong,Chittagong,Patenga,Ward No-40,0,0,0,0,0,0,0,0,0
Chittagong,Chittagong,Patenga,Ward No-41,0,0,0,0,0,0,0,0,0
Chittagong,Chittagong,Patenga,###,1,1,0,0,0,0,1,0,0
Chittagong,Chittagong,Bakalia,Ward No-18,1,1,0,0,0,0,1,0,0
Chittagong,Chittagong,Bakalia,Ward No-17,0,0,0,0,0,0,0,0,0
Chittagong,Chittagong,Bakalia,Ward No-19,0,0,0,0,0,0,0,0,0
Chittagong,Chittagong,Bakalia,Ward No-35 (part),0,0,0,0,0,0,0,0,0
Chittagong,Chittagong,Bakalia,###,1,1,0,0,0,0,1,0,0
Chittagong,Chittagong,Lohagara,Adhunagar,0,0,0,0,0,0,0,0,0
Chittagong,Chittagong,Lohagara,Amirabad,0,0,0,0,0,0,0,0,0
Chittagong,Chittagong,Lohagara,Barahatia,0,0,0,0,0,0,0,0,0
Chittagong,Chittagong,Lohagara,Charamba,0,0,0,0,0,0,0,0,0
Chittagong,Chittagong,Lohagara,Chunati,0,0,0,0,0,0,0,0,0
Chittagong,Chittagong,Lohagara,Kalauzan,0,0,0,0,0,0,0,0,0
Chittagong,Chittagong,Lohagara,Lohagara,0,0,0,0,0,0,0,0,0
Chittagong,Chittagong,Lohagara,Padua,0,0,0,0,0,0,0,0,0
Chittagong,Chittagong,Lohagara,Putibila,0,0,0,0,0,0,0,0,0
Chittagong,Chittagong,Lohagara,###,0,0,0,0,0,0,0,0,0
Chittagong,Chittagong,Satkania,Amilais,0,0,0,0,0,0,0,0,0
Chittagong,Chittagong,Satkania,Bazalia,0,0,0,0,0,0,0,0,0
Chittagong,Chittagong,Satkania,Charati,0,0,0,0,0,0,0,0,0
Chittagong,Chittagong,Satkania,Dharmapur,0,0,0,0,0,0,0,0,0
Chittagong,Chittagong,Satkania,Dhemsa,0,0,0,0,0,0,0,0,0
Chittagong,Chittagong,Satkania,Eochia,0,0,0,0,0,0,0,0,0
Chittagong,Chittagong,Satkania,Kaliais,0,0,0,0,0,0,0,0,0
Chittagong,Chittagong,Satkania,Kanchana,0,0,0,0,0,0,0,0,0
Chittagong,Chittagong,Satkania,Keochia,0,0,0,0,0,0,0,0,0
Chittagong,Chittagong,Satkania,Khagaria,0,0,0,0,0,0,0,0,0
Chittagong,Chittagong,Satkania,Madarsa,0,0,0,0,0,0,0,0,0
Chittagong,Chittagong,Satkania,Nalua,0,0,0,0,0,0,0,0,0
Chittagong,Chittagong,Satkania,Paschim Dhemsa,0,0,0,0,0,0,0,0,0
Chittagong,Chittagong,Satkania,Puranagar,0,0,0,0,0,0,0,0,0
Chittagong,Chittagong,Satkania,Sadaha,0,0,0,0,0,0,0,0,0
Chittagong,Chittagong,Satkania,Satkania,0,0,0,0,0,0,0,0,0
Chittagong,Chittagong,Satkania,Satkania Paurashava,0,0,0,0,0,0,0,0,0
Chittagong,Chittagong,Satkania,Sonakania,0,0,0,0,0,0,0,0,0
Chittagong,Chittagong,Satkania,###,0,0,0,0,0,0,0,0,0
Chittagong,Chittagong,Chandanaish,Bailtali,0,0,0,0,0,0,0,0,0
Chittagong,Chittagong,Chandanaish,Barama,0,0,0,0,0,0,0,0,0
Chittagong,Chittagong,Chandanaish,Barkal,0,0,0,0,0,0,0,0,0
Chittagong,Chittagong,Chandanaish,Chandanaish Paurashava,0,0,0,0,0,0,0,0,0
Chittagong,Chittagong,Chandanaish,Dhopachhari,0,0,0,0,0,0,0,0,0
Chittagong,Chittagong,Chandanaish,Dohazari,0,0,0,0,0,0,0,0,0
Chittagong,Chittagong,Chandanaish,Hashimpur,0,0,0,0,0,0,0,0,0
Chittagong,Chittagong,Chandanaish,Joara,0,0,0,0,0,0,0,0,0
Chittagong,Chittagong,Chandanaish,Kanchanabad,0,0,0,0,0,0,0,0,0
Chittagong,Chittagong,Chandanaish,Satbaria,0,0,0,0,0,0,0,0,0
Chittagong,Chittagong,Chandanaish,###,0,0,0,0,0,0,0,0,0
Chittagong,Chittagong,Rangunia,Betagi,0,0,0,0,0,0,0,0,0
Chittagong,Chittagong,Rangunia,Chandraghona Kadamtali,0,0,0,0,0,0,0,0,0
Chittagong,Chittagong,Rangunia,Hosnabad,0,0,0,0,0,0,0,0,0
Chittagong,Chittagong,Rangunia,Islampur,0,0,0,0,0,0,0,0,0
Chittagong,Chittagong,Rangunia,Kodala,0,0,0,0,0,0,0,0,0
Chittagong,Chittagong,Rangunia,Lalanagar,0,0,0,0,0,0,0,0,0
Chittagong,Chittagong,Rangunia,Mariamnagar,0,0,0,0,0,0,0,0,0
Chittagong,Chittagong,Rangunia,Padua,0,0,0,0,0,0,0,0,0
Chittagong,Chittagong,Rangunia,Parua,0,0,0,0,0,0,0,0,0
Chittagong,Chittagong,Rangunia,Pomara,0,0,0,0,0,0,0,0,0
Chittagong,Chittagong,Rangunia,Rajanagar,0,0,0,0,0,0,0,0,0
Chittagong,Chittagong,Rangunia,Rangunia,0,0,0,0,0,0,0,0,0
Chittagong,Chittagong,Rangunia,Rangunia Paurashava,0,0,0,0,0,0,0,0,0
Chittagong,Chittagong,Rangunia,Sarapbhata,0,0,0,0,0,0,0,0,0
Chittagong,Chittagong,Rangunia,Silok,0,0,0,0,0,0,0,0,0
Chittagong,Chittagong,Rangunia,South Rajanagar,0,0,0,0,0,0,0,0,0
Chittagong,Chittagong,Rangunia,###,0,0,0,0,0,0,0,0,0
Chittagong,Chittagong,Hathazari,Burir Char,0,0,0,0,0,0,0,0,0
Chittagong,Chittagong,Hathazari,Chhibatali,0,0,0,0,0,0,0,0,0
Chittagong,Chittagong,Hathazari,Chikandandi,0,0,0,0,0,0,0,0,0
Chittagong,Chittagong,Hathazari,Dakshin Madarsha,0,0,0,0,0,0,0,0,0
Chittagong,Chittagong,Hathazari,Dhalai,0,0,0,0,0,0,0,0,0
Chittagong,Chittagong,Hathazari,Fatehpur,0,0,0,0,0,0,0,0,0
Chittagong,Chittagong,Hathazari,Forhadabad,0,0,0,0,0,0,0,0,0
Chittagong,Chittagong,Hathazari,Garduara,0,0,0,0,0,0,0,0,0
Chittagong,Chittagong,Hathazari,Guman Mardan,0,0,0,0,0,0,0,0,0
Chittagong,Chittagong,Hathazari,Hathazari,0,0,0,0,0,0,0,0,0
Chittagong,Chittagong,Hathazari,Mekhal,0,0,0,0,0,0,0,0,0
Chittagong,Chittagong,Hathazari,Mirzapur,0,0,0,0,0,0,0,0,0
Chittagong,Chittagong,Hathazari,Nangalmora,0,0,0,0,0,0,0,0,0
Chittagong,Chittagong,Hathazari,Shikarpur,0,0,0,0,0,0,0,0,0
Chittagong,Chittagong,Hathazari,Uttar Madarsa,0,0,0,0,0,0,0,0,0
Chittagong,Chittagong,Hathazari,###,0,0,0,0,0,0,0,0,0
Chittagong,Chittagong,Bayejid Bostami,Ward No-01,0,0,0,0,0,0,0,0,0
Chittagong,Chittagong,Bayejid Bostami,Ward No-02,0,0,0,0,0,0,0,0,0
Chittagong,Chittagong,Bayejid Bostami,Ward No-03,0,0,0,0,0,0,0,0,0
Chittagong,Chittagong,Bayejid Bostami,###,0,0,0,0,0,0,0,0,0
Chittagong,Chittagong,Halishahar,Ward No-11 (Part),0,0,0,0,0,0,0,0,0
Chittagong,Chittagong,Halishahar,Ward No-24 (part),0,0,0,0,0,0,0,0,0
Chittagong,Chittagong,Halishahar,Ward No-25,0,0,0,0,0,0,0,0,0
Chittagong,Chittagong,Halishahar,Ward No-26,0,0,0,0,0,0,0,0,0
Chittagong,Chittagong,Halishahar,###,0,0,0,0,0,0,0,0,0
Chittagong,Chittagong,Chittagong Port,Ward No-36 (Part),0,0,0,0,0,0,0,0,0
Chittagong,Chittagong,Chittagong Port,Ward No-37,0,0,0,0,0,0,0,0,0
Chittagong,Chittagong,Chittagong Port,Ward No-38,0,0,0,0,0,0,0,0,0
Chittagong,Chittagong,Chittagong Port,Ward No-39 (Part),0,0,0,0,0,0,0,0,0
Chittagong,Chittagong,Chittagong Port,###,0,0,0,0,0,0,0,0,0
Chittagong,Chittagong,###,###,75,35,40,1,39,9,17,9,0
Chittagong,Comilla,Burichang,Mokam,2,1,1,0,1,0,1,0,0
Chittagong,Comilla,Burichang,Baksimail,3,1,2,0,2,0,1,0,0
Chittagong,Comilla,Burichang,Sholanal,3,1,2,0,2,0,1,0,0
Chittagong,Comilla,Burichang,Mainamati,1,1,0,0,0,0,0,1,0
Chittagong,Comilla,Burichang,Burichang,2,1,1,1,0,0,1,0,0
Chittagong,Comilla,Burichang,Rajapur,1,1,0,0,0,0,1,0,0
Chittagong,Comilla,Burichang,Pir Jatrapur,1,1,0,0,0,0,1,0,0
Chittagong,Comilla,Burichang,Bharella,0,0,0,0,0,0,0,0,0
Chittagong,Comilla,Burichang,###,13,7,6,1,5,0,6,1,0
Chittagong,Comilla,Manoharganj,Dakshin Jhalam,12,0,12,0,12,0,0,0,0
Chittagong,Comilla,Manoharganj,Baishgaon,8,1,7,0,7,0,1,0,0
Chittagong,Comilla,Manoharganj,Maisatua,12,0,12,0,12,0,0,0,0
Chittagong,Comilla,Manoharganj,Nather Petua,1,1,0,0,0,0,1,0,0
Chittagong,Comilla,Manoharganj,Khila,4,1,3,0,3,0,1,0,0
Chittagong,Comilla,Manoharganj,Lakshmanpur,5,1,4,0,4,0,1,0,0
Chittagong,Comilla,Manoharganj,Hasnabad,6,0,6,0,6,0,0,0,0
Chittagong,Comilla,Manoharganj,Uttar Jhalam,5,0,5,0,5,0,0,0,0
Chittagong,Comilla,Manoharganj,Sarashpur,3,0,3,0,3,0,0,0,0
Chittagong,Comilla,Manoharganj,Uttar Hawla,2,0,2,0,2,0,0,0,0
Chittagong,Comilla,Manoharganj,Bipulasar,0,0,0,0,0,0,0,0,0
Chittagong,Comilla,Manoharganj,###,58,4,54,0,54,0,4,0,0
Chittagong,Comilla,Muradnagar,Paschim Purbadhair,1,0,1,0,1,0,0,0,0
Chittagong,Comilla,Muradnagar,Paharpur,2,1,1,0,1,0,1,0,0
Chittagong,Comilla,Muradnagar,Paschim Nabipur,2,1,1,1,0,0,1,0,0
Chittagong,Comilla,Muradnagar,Sreekail,2,1,1,0,1,0,1,0,0
Chittagong,Comilla,Muradnagar,Uttar Ramchandrapur,1,1,0,0,0,0,1,0,0
Chittagong,Comilla,Muradnagar,Dhamghar,1,1,0,0,0,0,1,0,0
Chittagong,Comilla,Muradnagar,Purba Bangara,1,1,0,0,0,0,1,0,0
Chittagong,Comilla,Muradnagar,Akubpur,1,1,0,0,0,0,1,0,0
Chittagong,Comilla,Muradnagar,Jahapur,1,0,1,0,1,0,0,0,0
Chittagong,Comilla,Muradnagar,Andikot,0,0,0,0,0,0,0,0,0
Chittagong,Comilla,Muradnagar,Babuti Para,0,0,0,0,0,0,0,0,0
Chittagong,Comilla,Muradnagar,Chapitala,0,0,0,0,0,0,0,0,0
Chittagong,Comilla,Muradnagar,Chhaliakandi,0,0,0,0,0,0,0,0,0
Chittagong,Comilla,Muradnagar,Dakshin Ramchandrapur,0,0,0,0,0,0,0,0,0
Chittagong,Comilla,Muradnagar,Darora,0,0,0,0,0,0,0,0,0
Chittagong,Comilla,Muradnagar,Jatrapur,0,0,0,0,0,0,0,0,0
Chittagong,Comilla,Muradnagar,Kanalla,0,0,0,0,0,0,0,0,0
Chittagong,Comilla,Muradnagar,Muradnagar,0,0,0,0,0,0,0,0,0
Chittagong,Comilla,Muradnagar,Paschim Bangara,0,0,0,0,0,0,0,0,0
Chittagong,Comilla,Muradnagar,Purba Nabipur,0,0,0,0,0,0,0,0,0
Chittagong,Comilla,Muradnagar,Purba Purbadhair,0,0,0,0,0,0,0,0,0
Chittagong,Comilla,Muradnagar,Tanki,0,0,0,0,0,0,0,0,0
Chittagong,Comilla,Muradnagar,###,12,7,5,1,4,0,7,0,0
Chittagong,Comilla,Debidwar,Elahabad,1,0,1,0,1,0,0,0,0
Chittagong,Comilla,Debidwar,Mohan Pur,3,1,2,0,2,0,1,0,0
Chittagong,Comilla,Debidwar,Debidwar Paurashava,4,3,1,0,1,0,2,0,1
Chittagong,Comilla,Debidwar,Fatehabad,1,1,0,0,0,0,1,0,0
Chittagong,Comilla,Debidwar,Bara Shalghar,2,2,0,0,0,0,2,0,0
Chittagong,Comilla,Debidwar,Rasulpur,1,1,0,0,0,0,1,0,0
Chittagong,Comilla,Debidwar,Rajamehar,1,1,0,0,0,0,1,0,0
Chittagong,Comilla,Debidwar,Dakshin Dhamti,1,1,0,0,0,0,1,0,0
Chittagong,Comilla,Debidwar,Uttar Dhamti,1,1,0,0,0,0,1,0,0
Chittagong,Comilla,Debidwar,Uttar Gunaighar,1,1,0,0,0,0,1,0,0
Chittagong,Comilla,Debidwar,Isab Pur,2,0,2,0,2,0,0,0,0
Chittagong,Comilla,Debidwar,Barkamta,0,0,0,0,0,0,0,0,0
Chittagong,Comilla,Debidwar,Bhani,0,0,0,0,0,0,0,0,0
Chittagong,Comilla,Debidwar,Dakshin Gunaighar,0,0,0,0,0,0,0,0,0
Chittagong,Comilla,Debidwar,Debidwar,0,0,0,0,0,0,0,0,0
Chittagong,Comilla,Debidwar,Jafarganj,0,0,0,0,0,0,0,0,0
Chittagong,Comilla,Debidwar,Subil,0,0,0,0,0,0,0,0,0
Chittagong,Comilla,Debidwar,###,18,12,6,0,6,0,11,0,1
Chittagong,Comilla,Daudkandi,Barapara,2,0,2,0,2,0,0,0,0
Chittagong,Comilla,Daudkandi,Daudkandi Paurashava,4,1,3,1,2,0,1,0,0
Chittagong,Comilla,Daudkandi,Biteshwar,4,1,3,0,3,0,1,0,0
Chittagong,Comilla,Daudkandi,Gauripur,2,1,1,0,1,0,1,0,0
Chittagong,Comilla,Daudkandi,Uttar Elliotganj,2,1,1,0,1,0,1,0,0
Chittagong,Comilla,Daudkandi,Sundalpur,3,1,2,0,2,0,1,0,0
Chittagong,Comilla,Daudkandi,Padua,2,1,1,0,1,0,1,0,0
Chittagong,Comilla,Daudkandi,Mohammadpur Purba,1,0,1,0,1,0,0,0,0
Chittagong,Comilla,Daudkandi,Mohammadpur Paschim,1,0,1,0,1,0,0,0,0
Chittagong,Comilla,Daudkandi,Goalmari,2,0,2,0,2,0,0,0,0
Chittagong,Comilla,Daudkandi,Dakshin Elliotganj,2,0,2,0,2,0,0,0,0
Chittagong,Comilla,Daudkandi,Daulatpur (Purba Panchgachh),0,0,0,0,0,0,0,0,0
Chittagong,Comilla,Daudkandi,Jinglatali,0,0,0,0,0,0,0,0,0
Chittagong,Comilla,Daudkandi,Maruka,0,0,0,0,0,0,0,0,0
Chittagong,Comilla,Daudkandi,Paschim Panchgachhia,0,0,0,0,0,0,0,0,0
Chittagong,Comilla,Daudkandi,Uttar Daudkandi,0,0,0,0,0,0,0,0,0
Chittagong,Comilla,Daudkandi,###,25,6,19,1,18,0,6,0,0
Chittagong,Comilla,Chauddagram,Gunabati,2,0,2,0,2,0,0,0,0
Chittagong,Comilla,Chauddagram,Gholpasha,1,0,1,0,1,0,0,0,0
Chittagong,Comilla,Chauddagram,Batisha,1,1,0,0,0,0,0,1,0
Chittagong,Comilla,Chauddagram,Ujirpur,1,1,0,0,0,0,1,0,0
Chittagong,Comilla,Chauddagram,Chauddagram,1,1,0,0,0,0,1,0,0
Chittagong,Comilla,Chauddagram,Alkara,1,1,0,0,0,0,1,0,0
Chittagong,Comilla,Chauddagram,Sreepur,1,1,0,0,0,0,1,0,0
Chittagong,Comilla,Chauddagram,Munshirhat,1,1,0,0,0,0,1,0,0
Chittagong,Comilla,Chauddagram,Jagannath Dighi,1,1,0,0,0,1,0,0,0
Chittagong,Comilla,Chauddagram,Cheora,1,1,0,0,0,0,1,0,0
Chittagong,Comilla,Chauddagram,Kashinagar,1,1,0,0,0,0,1,0,0
Chittagong,Comilla,Chauddagram,Chauddagram Paurashava,1,0,1,0,1,0,0,0,0
Chittagong,Comilla,Chauddagram,Kalikapur,0,0,0,0,0,0,0,0,0
Chittagong,Comilla,Chauddagram,Kankapait,0,0,0,0,0,0,0,0,0
Chittagong,Comilla,Chauddagram,Shubhapur,0,0,0,0,0,0,0,0,0
Chittagong,Comilla,Chauddagram,###,13,9,4,0,4,1,7,1,0
Chittagong,Comilla,Nangalkot,Adra,3,1,2,0,2,1,0,0,0
Chittagong,Comilla,Nangalkot,Bakshaganj,1,0,1,0,1,0,0,0,0
Chittagong,Comilla,Nangalkot,Jodda,1,1,0,0,0,0,0,1,0
Chittagong,Comilla,Nangalkot,Roykot,2,1,1,1,0,0,1,0,0
Chittagong,Comilla,Nangalkot,Nangalkot Paurashava,1,1,0,0,0,0,0,1,0
Chittagong,Comilla,Nangalkot,Dhalua,1,1,0,0,0,1,0,0,0
Chittagong,Comilla,Nangalkot,Mokara,1,1,0,0,0,0,1,0,0
Chittagong,Comilla,Nangalkot,Daulkhar,1,1,0,0,0,1,0,0,0
Chittagong,Comilla,Nangalkot,Bangodda,0,0,0,0,0,0,0,0,0
Chittagong,Comilla,Nangalkot,Hesakhal,0,0,0,0,0,0,0,0,0
Chittagong,Comilla,Nangalkot,Mokrabpur,0,0,0,0,0,0,0,0,0
Chittagong,Comilla,Nangalkot,Nangalkot,0,0,0,0,0,0,0,0,0
Chittagong,Comilla,Nangalkot,Peria,0,0,0,0,0,0,0,0,0
Chittagong,Comilla,Nangalkot,Satbaria,0,0,0,0,0,0,0,0,0
Chittagong,Comilla,Nangalkot,###,11,7,4,1,3,3,2,2,0
Chittagong,Comilla,Chandina,Joyag (dakshin Bara Karai),2,1,1,0,1,0,1,0,0
Chittagong,Comilla,Chandina,Barkait (purba Chandina Uni),1,1,0,0,0,0,1,0,0
Chittagong,Comilla,Chandina,Chandina Paurashava,2,1,1,1,0,0,1,0,0
Chittagong,Comilla,Chandina,Maijkhara,1,1,0,0,0,0,1,0,0
Chittagong,Comilla,Chandina,Bara Karai (uttar Bara Karai),1,1,0,0,0,0,1,0,0
Chittagong,Comilla,Chandina,Gallai (uttar Gallai Union),1,1,0,0,0,0,1,0,0
Chittagong,Comilla,Chandina,Barera,1,1,0,0,0,0,1,0,0
Chittagong,Comilla,Chandina,Mahichal,1,1,0,0,0,0,1,0,0
Chittagong,Comilla,Chandina,Atbar Pur (Paschim Chandina),0,0,0,0,0,0,0,0,0
Chittagong,Comilla,Chandina,Batakashi (purba Silpur),0,0,0,0,0,0,0,0,0
Chittagong,Comilla,Chandina,Dollai Nowabab Pur,0,0,0,0,0,0,0,0,0
Chittagong,Comilla,Chandina,Keran Khal,0,0,0,0,0,0,0,0,0
Chittagong,Comilla,Chandina,Madhya (mechachal Union),0,0,0,0,0,0,0,0,0
Chittagong,Comilla,Chandina,Suhilpur (paschim Silpur),0,0,0,0,0,0,0,0,0
Chittagong,Comilla,Chandina,###,10,8,2,1,1,0,8,0,0
Chittagong,Comilla,Laksam,Uttardah,1,0,1,0,1,0,0,0,0
Chittagong,Comilla,Laksam,Ajgara,1,0,1,0,1,0,0,0,0
Chittagong,Comilla,Laksam,Laksam Paurashava,2,1,1,1,0,0,1,0,0
Chittagong,Comilla,Laksam,Gobindapur,1,1,0,0,0,0,1,0,0
Chittagong,Comilla,Laksam,Mudafarganj,1,1,0,0,0,0,1,0,0
Chittagong,Comilla,Laksam,Bakai,0,0,0,0,0,0,0,0,0
Chittagong,Comilla,Laksam,Kandirpar,0,0,0,0,0,0,0,0,0
Chittagong,Comilla,Laksam,Laksam,0,0,0,0,0,0,0,0,0
Chittagong,Comilla,Laksam,###,6,3,3,1,2,0,3,0,0
Chittagong,Comilla,Meghna,Chalibhanga,2,0,2,0,2,0,0,0,0
Chittagong,Comilla,Meghna,Radhanagar,6,0,6,0,6,0,0,0,0
Chittagong,Comilla,Meghna,Barakanda,0,0,0,0,0,0,0,0,0
Chittagong,Comilla,Meghna,Chandanpur,0,0,0,0,0,0,0,0,0
Chittagong,Comilla,Meghna,Gobindapur,0,0,0,0,0,0,0,0,0
Chittagong,Comilla,Meghna,Luter Char,0,0,0,0,0,0,0,0,0
Chittagong,Comilla,Meghna,Maniker Char,0,0,0,0,0,0,0,0,0
Chittagong,Comilla,Meghna,###,8,0,8,0,8,0,0,0,0
Chittagong,Comilla,Barura,Adra,1,0,1,0,1,0,0,0,0
Chittagong,Comilla,Barura,Barura Paurashava,2,1,1,1,0,0,0,1,0
Chittagong,Comilla,Barura,Bhabanipur,1,1,0,0,0,0,1,0,0
Chittagong,Comilla,Barura,Dakshin Shilmuri,1,1,0,0,0,0,0,1,0
Chittagong,Comilla,Barura,Galimpur,3,1,2,0,2,0,1,0,0
Chittagong,Comilla,Barura,Jalam,1,1,0,0,0,0,1,0,0
Chittagong,Comilla,Barura,Uttar Payalgachha,1,1,0,0,0,0,1,0,0
Chittagong,Comilla,Barura,Aganagar,1,1,0,0,0,0,1,0,0
Chittagong,Comilla,Barura,Dakshin Khosbas,3,1,2,1,1,0,1,0,0
Chittagong,Comilla,Barura,Adda,1,1,0,0,0,0,1,0,0
Chittagong,Comilla,Barura,Chitadda,0,0,0,0,0,0,0,0,0
Chittagong,Comilla,Barura,Deora,0,0,0,0,0,0,0,0,0
Chittagong,Comilla,Barura,Lakshmipur,0,0,0,0,0,0,0,0,0
Chittagong,Comilla,Barura,Uttar Khosbas,0,0,0,0,0,0,0,0,0
Chittagong,Comilla,Barura,Uttar Shilmuri,0,0,0,0,0,0,0,0,0
Chittagong,Comilla,Barura,###,15,9,6,2,4,0,7,2,0
Chittagong,Comilla,Comilla Adarsha Sadar,Amratali,2,1,1,0,1,0,0,1,0
Chittagong,Comilla,Comilla Adarsha Sadar,Kalir Bazar (Dakshin),1,1,0,0,0,0,1,0,0
Chittagong,Comilla,Comilla Adarsha Sadar,Comilla Paurashava,2,1,1,1,0,0,0,1,0
Chittagong,Comilla,Comilla Adarsha Sadar,Jagannathpur,2,1,1,0,1,0,0,1,0
Chittagong,Comilla,Comilla Adarsha Sadar,Panchthubi,1,1,0,0,0,0,0,1,0
Chittagong,Comilla,Comilla Adarsha Sadar,Uttar Durgapur,1,0,1,0,1,0,0,0,0
Chittagong,Comilla,Comilla Adarsha Sadar,Dakshin Durgapur,0,0,0,0,0,0,0,0,0
Chittagong,Comilla,Comilla Adarsha Sadar,Kalir Bazar (Uttar),0,0,0,0,0,0,0,0,0
Chittagong,Comilla,Comilla Adarsha Sadar,###,9,5,4,1,3,0,1,4,0
Chittagong,Comilla,Comilla Sadar Dakshin,Paschim Jorekaran,2,1,1,0,1,0,0,1,0
Chittagong,Comilla,Comilla Sadar Dakshin,Chouara,1,1,0,0,0,0,1,0,0
Chittagong,Comilla,Comilla Sadar Dakshin,Galiara,1,1,0,0,0,0,1,0,0
Chittagong,Comilla,Comilla Sadar Dakshin,Comilla Dakshin Paurashava,2,1,1,0,1,0,0,1,0
Chittagong,Comilla,Comilla Sadar Dakshin,Bijoypur,2,1,1,0,1,0,0,1,0
Chittagong,Comilla,Comilla Sadar Dakshin,Baghmara,1,1,0,0,0,0,1,0,0
Chittagong,Comilla,Comilla Sadar Dakshin,Perul (Uttar),1,1,0,0,0,0,1,0,0
Chittagong,Comilla,Comilla Sadar Dakshin,Belghar,1,1,0,0,0,0,1,0,0
Chittagong,Comilla,Comilla Sadar Dakshin,Baghmara Uttar,0,0,0,0,0,0,0,0,0
Chittagong,Comilla,Comilla Sadar Dakshin,Bara Para,0,0,0,0,0,0,0,0,0
Chittagong,Comilla,Comilla Sadar Dakshin,Belghar Uttar,0,0,0,0,0,0,0,0,0
Chittagong,Comilla,Comilla Sadar Dakshin,Bholain (Dakshin),0,0,0,0,0,0,0,0,0
Chittagong,Comilla,Comilla Sadar Dakshin,Bholain (Uttar),0,0,0,0,0,0,0,0,0
Chittagong,Comilla,Comilla Sadar Dakshin,Perul (Dakshin),0,0,0,0,0,0,0,0,0
Chittagong,Comilla,Comilla Sadar Dakshin,Purba Jorekaran,0,0,0,0,0,0,0,0,0
Chittagong,Comilla,Comilla Sadar Dakshin,###,11,8,3,0,3,0,5,3,0
Chittagong,Comilla,Brahman Para,Dulalpur,1,1,0,0,0,0,0,1,0
Chittagong,Comilla,Brahman Para,Sahebabad,1,1,0,0,0,0,1,0,0
Chittagong,Comilla,Brahman Para,Chandla,1,1,0,0,0,0,1,0,0
Chittagong,Comilla,Brahman Para,Brahman Para,2,1,1,1,0,0,1,0,0
Chittagong,Comilla,Brahman Para,Shashidal,1,1,0,0,0,0,1,0,0
Chittagong,Comilla,Brahman Para,Madhabpur,1,1,0,0,0,0,1,0,0
Chittagong,Comilla,Brahman Para,Malapara,1,0,1,0,1,0,0,0,0
Chittagong,Comilla,Brahman Para,Sidlai,0,0,0,0,0,0,0,0,0
Chittagong,Comilla,Brahman Para,###,8,6,2,1,1,0,5,1,0
Chittagong,Comilla,Homna,Bhasania,1,1,0,0,0,1,0,0,0
Chittagong,Comilla,Homna,Homna Paurashava,2,2,0,0,0,1,1,0,0
Chittagong,Comilla,Homna,Mathabanga,1,1,0,0,0,0,1,0,0
Chittagong,Comilla,Homna,Garmora,1,1,0,0,0,0,1,0,0
Chittagong,Comilla,Homna,Dulal Pur,1,1,0,0,0,0,1,0,0
Chittagong,Comilla,Homna,Chander Char,1,1,0,0,0,1,0,0,0
Chittagong,Comilla,Homna,Ghagutia,1,1,0,0,0,1,0,0,0
Chittagong,Comilla,Homna,Asad Pur,0,0,0,0,0,0,0,0,0
Chittagong,Comilla,Homna,Homna Union,0,0,0,0,0,0,0,0,0
Chittagong,Comilla,Homna,Joypur,0,0,0,0,0,0,0,0,0
Chittagong,Comilla,Homna,Nilakhi,0,0,0,0,0,0,0,0,0
Chittagong,Comilla,Homna,###,8,8,0,0,0,4,4,0,0
Chittagong,Comilla,Titas,Karikandi,2,1,1,0,1,0,1,0,0
Chittagong,Comilla,Titas,Balarampur,1,1,0,0,0,0,1,0,0
Chittagong,Comilla,Titas,Bitikandi,0,0,0,0,0,0,0,0,0
Chittagong,Comilla,Titas,Jagatpur,0,0,0,0,0,0,0,0,0
Chittagong,Comilla,Titas,Jiarkandi,0,0,0,0,0,0,0,0,0
Chittagong,Comilla,Titas,Kala Kandi,0,0,0,0,0,0,0,0,0
Chittagong,Comilla,Titas,Majidpur,0,0,0,0,0,0,0,0,0
Chittagong,Comilla,Titas,Narayandia,0,0,0,0,0,0,0,0,0
Chittagong,Comilla,Titas,Satani,0,0,0,0,0,0,0,0,0
Chittagong,Comilla,Titas,###,3,2,1,0,1,0,2,0,0
Chittagong,Comilla,###,###,228,101,127,10,117,8,78,14,1
Chittagong,Brahamanbaria,Brahmanbaria Sadar,Dakshin Natai,1,0,1,0,1,0,0,0,0
Chittagong,Brahamanbaria,Brahmanbaria Sadar,Sultanpur,2,1,1,0,1,0,1,0,0
Chittagong,Brahamanbaria,Brahmanbaria Sadar,Brahmanbaria Paurashava,3,1,2,0,2,0,0,1,0
Chittagong,Brahamanbaria,Brahmanbaria Sadar,Majlishpur,1,1,0,0,0,0,0,1,0
Chittagong,Brahamanbaria,Brahmanbaria Sadar,Purba Talsahar,2,2,0,0,0,0,1,1,0
Chittagong,Brahamanbaria,Brahmanbaria Sadar,Basudeb,1,1,0,0,0,0,1,0,0
Chittagong,Brahamanbaria,Brahmanbaria Sadar,Budhal,0,0,0,0,0,0,0,0,0
Chittagong,Brahamanbaria,Brahmanbaria Sadar,Dakshin Shuhilpur,0,0,0,0,0,0,0,0,0
Chittagong,Brahamanbaria,Brahmanbaria Sadar,Machhihata,0,0,0,0,0,0,0,0,0
Chittagong,Brahamanbaria,Brahmanbaria Sadar,Ramrail,0,0,0,0,0,0,0,0,0
Chittagong,Brahamanbaria,Brahmanbaria Sadar,Sadekpur,0,0,0,0,0,0,0,0,0
Chittagong,Brahamanbaria,Brahmanbaria Sadar,Uttar Natai,0,0,0,0,0,0,0,0,0
Chittagong,Brahamanbaria,Brahmanbaria Sadar,###,10,6,4,0,4,0,3,3,0
Chittagong,Brahamanbaria,Nabinagar,Rasullabad,2,1,1,0,1,0,0,1,0
Chittagong,Brahamanbaria,Nabinagar,Biddyakut,1,1,0,0,0,0,0,1,0
Chittagong,Brahamanbaria,Nabinagar,Nabinagar Paurashava,2,1,1,0,1,0,1,0,0
Chittagong,Brahamanbaria,Nabinagar,Ibrahimpur,1,1,0,0,0,0,1,0,0
Chittagong,Brahamanbaria,Nabinagar,Ratanpur,1,1,0,0,0,0,1,0,0
Chittagong,Brahamanbaria,Nabinagar,Barail,1,1,0,0,0,0,1,0,0
Chittagong,Brahamanbaria,Nabinagar,Junedpur,1,1,0,0,0,0,1,0,0
Chittagong,Brahamanbaria,Nabinagar,Shyamgram,1,1,0,0,0,0,1,0,0
Chittagong,Brahamanbaria,Nabinagar,Barikandi,0,0,0,0,0,0,0,0,0
Chittagong,Brahamanbaria,Nabinagar,Birgaon,0,0,0,0,0,0,0,0,0
Chittagong,Brahamanbaria,Nabinagar,Bitghar (tiara),0,0,0,0,0,0,0,0,0
Chittagong,Brahamanbaria,Nabinagar,Kaitala Dakshin,0,0,0,0,0,0,0,0,0
Chittagong,Brahamanbaria,Nabinagar,Kaitala Uttar,0,0,0,0,0,0,0,0,0
Chittagong,Brahamanbaria,Nabinagar,Krishnanagar,0,0,0,0,0,0,0,0,0
Chittagong,Brahamanbaria,Nabinagar,Laur Fatehpur,0,0,0,0,0,0,0,0,0
Chittagong,Brahamanbaria,Nabinagar,Natghar,0,0,0,0,0,0,0,0,0
Chittagong,Brahamanbaria,Nabinagar,Paschim Nabinagar,0,0,0,0,0,0,0,0,0
Chittagong,Brahamanbaria,Nabinagar,Purba Nabinagar,0,0,0,0,0,0,0,0,0
Chittagong,Brahamanbaria,Nabinagar,Salimganj,0,0,0,0,0,0,0,0,0
Chittagong,Brahamanbaria,Nabinagar,Satmura,0,0,0,0,0,0,0,0,0
Chittagong,Brahamanbaria,Nabinagar,Shibpur,0,0,0,0,0,0,0,0,0
Chittagong,Brahamanbaria,Nabinagar,Sreerampur,0,0,0,0,0,0,0,0,0
Chittagong,Brahamanbaria,Nabinagar,###,10,8,2,0,2,0,6,2,0
Chittagong,Brahamanbaria,Sarail,Sarail,2,1,1,0,1,0,1,0,0
Chittagong,Brahamanbaria,Sarail,Kalikachchha,2,1,1,0,1,0,0,1,0
Chittagong,Brahamanbaria,Sarail,Chunta,2,1,1,0,1,0,1,0,0
Chittagong,Brahamanbaria,Sarail,Aorail,1,0,1,0,1,0,0,0,0
Chittagong,Brahamanbaria,Sarail,Shahjadapur,1,1,0,0,0,0,0,1,0
Chittagong,Brahamanbaria,Sarail,Shahbazpur,1,1,0,0,0,0,1,0,0
Chittagong,Brahamanbaria,Sarail,Noagaon,0,0,0,0,0,0,0,0,0
Chittagong,Brahamanbaria,Sarail,Pak Shimul,0,0,0,0,0,0,0,0,0
Chittagong,Brahamanbaria,Sarail,Uttar Panisar,0,0,0,0,0,0,0,0,0
Chittagong,Brahamanbaria,Sarail,###,9,5,4,0,4,0,3,2,0
Chittagong,Brahamanbaria,Bijoynagar,Harashpur,1,0,1,0,1,0,0,0,0
Chittagong,Brahamanbaria,Bijoynagar,Char Islmapur,2,0,2,0,2,0,0,0,0
Chittagong,Brahamanbaria,Bijoynagar,Uttar Ichhapur,1,0,1,0,1,0,0,0,0
Chittagong,Brahamanbaria,Bijoynagar,Budhanti,1,1,0,0,0,0,1,0,0
Chittagong,Brahamanbaria,Bijoynagar,Pattan,1,1,0,0,0,0,1,0,0
Chittagong,Brahamanbaria,Bijoynagar,Paharpur,1,1,0,0,0,1,0,0,0
Chittagong,Brahamanbaria,Bijoynagar,Bishnupur,0,0,0,0,0,0,0,0,0
Chittagong,Brahamanbaria,Bijoynagar,Champaknagar,0,0,0,0,0,0,0,0,0
Chittagong,Brahamanbaria,Bijoynagar,Chandura,0,0,0,0,0,0,0,0,0
Chittagong,Brahamanbaria,Bijoynagar,Dakshin Singerbil,0,0,0,0,0,0,0,0,0
Chittagong,Brahamanbaria,Bijoynagar,###,7,3,4,0,4,1,2,0,0
Chittagong,Brahamanbaria,Nasirnagar,Chapartala,1,0,1,0,1,0,0,0,0
Chittagong,Brahamanbaria,Nasirnagar,Burishwar,2,2,0,0,0,0,0,2,0
Chittagong,Brahamanbaria,Nasirnagar,Gokarna,1,1,0,0,0,0,0,1,0
Chittagong,Brahamanbaria,Nasirnagar,Fandauk,1,1,0,0,0,0,0,0,1
Chittagong,Brahamanbaria,Nasirnagar,Kunda,1,1,0,0,0,0,0,1,0
Chittagong,Brahamanbaria,Nasirnagar,Nasirnagar,1,1,0,0,0,0,0,1,0
Chittagong,Brahamanbaria,Nasirnagar,Bolakot,0,0,0,0,0,0,0,0,0
Chittagong,Brahamanbaria,Nasirnagar,Chatalpar,0,0,0,0,0,0,0,0,0
Chittagong,Brahamanbaria,Nasirnagar,Dhar Mandal,0,0,0,0,0,0,0,0,0
Chittagong,Brahamanbaria,Nasirnagar,Goalnagar,0,0,0,0,0,0,0,0,0
Chittagong,Brahamanbaria,Nasirnagar,Guniak,0,0,0,0,0,0,0,0,0
Chittagong,Brahamanbaria,Nasirnagar,Haripur,0,0,0,0,0,0,0,0,0
Chittagong,Brahamanbaria,Nasirnagar,Purbabagh,0,0,0,0,0,0,0,0,0
Chittagong,Brahamanbaria,Nasirnagar,###,7,6,1,0,1,0,0,5,1
Chittagong,Brahamanbaria,Ashuganj,Araisidha,1,0,1,0,1,0,0,0,0
Chittagong,Brahamanbaria,Ashuganj,Lal Pur,1,1,0,0,0,0,1,0,0
Chittagong,Brahamanbaria,Ashuganj,Ashugang,1,1,0,0,0,0,1,0,0
Chittagong,Brahamanbaria,Ashuganj,Char Chartala,0,0,0,0,0,0,0,0,0
Chittagong,Brahamanbaria,Ashuganj,Durgapur,0,0,0,0,0,0,0,0,0
Chittagong,Brahamanbaria,Ashuganj,Paschim Talsahar,0,0,0,0,0,0,0,0,0
Chittagong,Brahamanbaria,Ashuganj,Sharifpur,0,0,0,0,0,0,0,0,0
Chittagong,Brahamanbaria,Ashuganj,Tarua,0,0,0,0,0,0,0,0,0
Chittagong,Brahamanbaria,Ashuganj,###,3,2,1,0,1,0,2,0,0
Chittagong,Brahamanbaria,Banchharampur,Salimabad,1,0,1,0,1,0,0,0,0
Chittagong,Brahamanbaria,Banchharampur,Tezkhali,2,1,1,0,1,0,1,0,0
Chittagong,Brahamanbaria,Banchharampur,Dariadaulat,3,2,1,0,1,0,2,0,0
Chittagong,Brahamanbaria,Banchharampur,Sonarampur,1,1,0,0,0,0,1,0,0
Chittagong,Brahamanbaria,Banchharampur,Dakshin Banchharampur,1,1,0,0,0,0,1,0,0
Chittagong,Brahamanbaria,Banchharampur,Purba Ujan Char,1,1,0,0,0,0,1,0,0
Chittagong,Brahamanbaria,Banchharampur,Uttar Banchharampur,1,1,0,0,0,0,1,0,0
Chittagong,Brahamanbaria,Banchharampur,Pahariakandi,0,0,0,0,0,0,0,0,0
Chittagong,Brahamanbaria,Banchharampur,Paschim Rupasdi,0,0,0,0,0,0,0,0,0
Chittagong,Brahamanbaria,Banchharampur,Paschim Saifullakandi,0,0,0,0,0,0,0,0,0
Chittagong,Brahamanbaria,Banchharampur,Paschim Ujan Char,0,0,0,0,0,0,0,0,0
Chittagong,Brahamanbaria,Banchharampur,Purba Rupasdi,0,0,0,0,0,0,0,0,0
Chittagong,Brahamanbaria,Banchharampur,Purba Saifullakandi,0,0,0,0,0,0,0,0,0
Chittagong,Brahamanbaria,Banchharampur,###,10,7,3,0,3,0,7,0,0
Chittagong,Brahamanbaria,Kasba,Badair,1,0,1,0,1,0,0,0,0
Chittagong,Brahamanbaria,Kasba,Binauti,2,0,2,1,1,0,0,0,0
Chittagong,Brahamanbaria,Kasba,Kherera,1,1,0,0,0,0,0,1,0
Chittagong,Brahamanbaria,Kasba,Kasba,1,1,0,0,0,0,1,0,0
Chittagong,Brahamanbaria,Kasba,Gopinathpur,1,1,0,0,0,0,1,0,0
Chittagong,Brahamanbaria,Kasba,Kaimpur,1,1,0,0,0,0,1,0,0
Chittagong,Brahamanbaria,Kasba,Bayek,1,1,0,0,0,0,1,0,0
Chittagong,Brahamanbaria,Kasba,Kuti,1,1,0,0,0,0,1,0,0
Chittagong,Brahamanbaria,Kasba,Mehari,1,1,0,0,0,0,1,0,0
Chittagong,Brahamanbaria,Kasba,Kasba Paurashava,0,0,0,0,0,0,0,0,0
Chittagong,Brahamanbaria,Kasba,Mulgram,0,0,0,0,0,0,0,0,0
Chittagong,Brahamanbaria,Kasba,###,10,7,3,1,2,0,6,1,0
Chittagong,Brahamanbaria,Akhaura,Dakshin Akhaura,2,2,0,0,0,0,1,0,1
Chittagong,Brahamanbaria,Akhaura,Mogra,2,2,0,0,0,0,2,0,0
Chittagong,Brahamanbaria,Akhaura,Uttar Akhaura,2,2,0,0,0,0,2,0,0
Chittagong,Brahamanbaria,Akhaura,Maniand,1,1,0,0,0,0,1,0,0
Chittagong,Brahamanbaria,Akhaura,Dharkhar,2,2,0,0,0,0,1,0,1
Chittagong,Brahamanbaria,Akhaura,Akhaura Paurashava,0,0,0,0,0,0,0,0,0
Chittagong,Brahamanbaria,Akhaura,###,9,9,0,0,0,0,7,0,2
Chittagong,Brahamanbaria,###,###,75,53,22,1,21,1,36,13,3
Chittagong,Cox's Bazar,Chakaria,Badarkhali,1,0,1,0,1,0,0,0,0
Chittagong,Cox's Bazar,Chakaria,Chiringa,3,1,2,0,2,0,1,0,0
Chittagong,Cox's Bazar,Chakaria,Baraitali,1,1,0,0,0,0,0,0,1
Chittagong,Cox's Bazar,Chakaria,Dulahazara,2,2,0,0,0,0,1,1,0
Chittagong,Cox's Bazar,Chakaria,Khuntakhali,2,0,2,0,2,0,0,0,0
Chittagong,Cox's Bazar,Chakaria,Bheola Manik Char,2,0,2,0,2,0,0,0,0
Chittagong,Cox's Bazar,Chakaria,Bamo Bilchari,0,0,0,0,0,0,0,0,0
Chittagong,Cox's Bazar,Chakaria,Chakaria Paurashava,0,0,0,0,0,0,0,0,0
Chittagong,Cox's Bazar,Chakaria,Demusia,0,0,0,0,0,0,0,0,0
Chittagong,Cox's Bazar,Chakaria,Fasiakhali,0,0,0,0,0,0,0,0,0
Chittagong,Cox's Bazar,Chakaria,Harbang,0,0,0,0,0,0,0,0,0
Chittagong,Cox's Bazar,Chakaria,Kaiarbil,0,0,0,0,0,0,0,0,0
Chittagong,Cox's Bazar,Chakaria,Kakhara,0,0,0,0,0,0,0,0,0
Chittagong,Cox's Bazar,Chakaria,Konakhali,0,0,0,0,0,0,0,0,0
Chittagong,Cox's Bazar,Chakaria,Lakhyarchar,0,0,0,0,0,0,0,0,0
Chittagong,Cox's Bazar,Chakaria,Paschim Bara Bheola,0,0,0,0,0,0,0,0,0
Chittagong,Cox's Bazar,Chakaria,Purba Barabheola,0,0,0,0,0,0,0,0,0
Chittagong,Cox's Bazar,Chakaria,Saharbil,0,0,0,0,0,0,0,0,0
Chittagong,Cox's Bazar,Chakaria,Surajpur Manikpur,0,0,0,0,0,0,0,0,0
Chittagong,Cox's Bazar,Chakaria,###,11,4,7,0,7,0,2,1,1
Chittagong,Cox's Bazar,Maheshkhali,Hoanak,5,3,2,0,2,1,2,0,0
Chittagong,Cox's Bazar,Maheshkhali,Bara Maheskhali,1,1,0,0,0,0,1,0,0
Chittagong,Cox's Bazar,Maheshkhali,Maheshkhali Paurashava,1,1,0,0,0,0,1,0,0
Chittagong,Cox's Bazar,Maheshkhali,Chhotamohes Khali,0,0,0,0,0,0,0,0,0
Chittagong,Cox's Bazar,Maheshkhali,Dhalghata,0,0,0,0,0,0,0,0,0
Chittagong,Cox's Bazar,Maheshkhali,Kalarmarchhara,0,0,0,0,0,0,0,0,0
Chittagong,Cox's Bazar,Maheshkhali,Kutubjom,0,0,0,0,0,0,0,0,0
Chittagong,Cox's Bazar,Maheshkhali,Matarbari,0,0,0,0,0,0,0,0,0
Chittagong,Cox's Bazar,Maheshkhali,Saflapur,0,0,0,0,0,0,0,0,0
Chittagong,Cox's Bazar,Maheshkhali,###,7,5,2,0,2,1,4,0,0
Chittagong,Cox's Bazar,Pekua,Pekua,2,0,2,0,2,0,0,0,0
Chittagong,Cox's Bazar,Pekua,Bara Bakia,1,1,0,0,0,0,0,0,1
Chittagong,Cox's Bazar,Pekua,Magnama,0,0,0,0,0,0,0,0,0
Chittagong,Cox's Bazar,Pekua,Rajakhali,0,0,0,0,0,0,0,0,0
Chittagong,Cox's Bazar,Pekua,Shilkhali,0,0,0,0,0,0,0,0,0
Chittagong,Cox's Bazar,Pekua,Taitong,0,0,0,0,0,0,0,0,0
Chittagong,Cox's Bazar,Pekua,Ujantia,0,0,0,0,0,0,0,0,0
Chittagong,Cox's Bazar,Pekua,###,3,1,2,0,2,0,0,0,1
Chittagong,Cox's Bazar,Cox's Bazar Sadar,Islamabad,2,0,2,0,2,0,0,0,0
Chittagong,Cox's Bazar,Cox's Bazar Sadar,Cox's Bazar Paurashava,2,1,1,1,0,1,0,0,0
Chittagong,Cox's Bazar,Cox's Bazar Sadar,Jalalabad,1,1,0,0,0,0,0,1,0
Chittagong,Cox's Bazar,Cox's Bazar Sadar,Patali Machhuakhali,1,1,0,0,0,0,0,1,0
Chittagong,Cox's Bazar,Cox's Bazar Sadar,Bharuakhali,2,0,2,0,2,0,0,0,0
Chittagong,Cox's Bazar,Cox's Bazar Sadar,Jhilwanja,4,1,3,0,3,0,1,0,0
Chittagong,Cox's Bazar,Cox's Bazar Sadar,Chaufaldandi,0,0,0,0,0,0,0,0,0
Chittagong,Cox's Bazar,Cox's Bazar Sadar,Idgaon,0,0,0,0,0,0,0,0,0
Chittagong,Cox's Bazar,Cox's Bazar Sadar,Islampur,0,0,0,0,0,0,0,0,0
Chittagong,Cox's Bazar,Cox's Bazar Sadar,Khurushkul,0,0,0,0,0,0,0,0,0
Chittagong,Cox's Bazar,Cox's Bazar Sadar,Pokkhali,0,0,0,0,0,0,0,0,0
Chittagong,Cox's Bazar,Cox's Bazar Sadar,###,12,4,8,1,7,1,1,2,0
Chittagong,Cox's Bazar,Teknaf,Nhilla,6,2,4,0,4,0,2,0,0
Chittagong,Cox's Bazar,Teknaf,Teknaf Paurashava,1,1,0,0,0,1,0,0,0
Chittagong,Cox's Bazar,Teknaf,Sabrang,1,1,0,0,0,1,0,0,0
Chittagong,Cox's Bazar,Teknaf,Baharchhara,0,0,0,0,0,0,0,0,0
Chittagong,Cox's Bazar,Teknaf,St.Martin Dwip,0,0,0,0,0,0,0,0,0
Chittagong,Cox's Bazar,Teknaf,Teknaf,0,0,0,0,0,0,0,0,0
Chittagong,Cox's Bazar,Teknaf,Whykong,0,0,0,0,0,0,0,0,0
Chittagong,Cox's Bazar,Teknaf,###,8,4,4,0,4,2,2,0,0
Chittagong,Cox's Bazar,Ramu,Joarianala,1,0,1,1,0,0,0,0,0
Chittagong,Cox's Bazar,Ramu,Rajarkul,1,0,1,1,0,0,0,0,0
Chittagong,Cox's Bazar,Ramu,Chakmarkul,3,1,2,0,2,0,0,0,1
Chittagong,Cox's Bazar,Ramu,Khuniapalong,1,1,0,0,0,0,0,1,0
Chittagong,Cox's Bazar,Ramu,Dakshin Mithachhari,1,1,0,0,0,0,1,0,0
Chittagong,Cox's Bazar,Ramu,Kauarkhop,1,1,0,0,0,0,1,0,0
Chittagong,Cox's Bazar,Ramu,Kachhapia,1,1,0,0,0,0,0,1,0
Chittagong,Cox's Bazar,Ramu,Fatekharkul,0,0,0,0,0,0,0,0,0
Chittagong,Cox's Bazar,Ramu,Garjania,0,0,0,0,0,0,0,0,0
Chittagong,Cox's Bazar,Ramu,Idgar,0,0,0,0,0,0,0,0,0
Chittagong,Cox's Bazar,Ramu,Rashid Nagar,0,0,0,0,0,0,0,0,0
Chittagong,Cox's Bazar,Ramu,###,9,5,4,2,2,0,2,2,1
Chittagong,Cox's Bazar,Ukhia,Raja Palong,3,1,2,0,2,0,1,0,0
Chittagong,Cox's Bazar,Ukhia,Jalia Palong,2,2,0,0,0,1,1,0,0
Chittagong,Cox's Bazar,Ukhia,Palong Khali,2,2,0,0,0,1,1,0,0
Chittagong,Cox's Bazar,Ukhia,Haldia Palong,1,1,0,0,0,1,0,0,0
Chittagong,Cox's Bazar,Ukhia,Ratna Palong,1,1,0,0,0,0,1,0,0
Chittagong,Cox's Bazar,Ukhia,###,9,7,2,0,2,3,4,0,0
Chittagong,Cox's Bazar,Kutubdia,Ali Akbar Deil,0,0,0,0,0,0,0,0,0
Chittagong,Cox's Bazar,Kutubdia,Baraghop,0,0,0,0,0,0,0,0,0
Chittagong,Cox's Bazar,Kutubdia,Dakshin Dhurung,0,0,0,0,0,0,0,0,0
Chittagong,Cox's Bazar,Kutubdia,Kaiyarbil,0,0,0,0,0,0,0,0,0
Chittagong,Cox's Bazar,Kutubdia,Lemsikhali,0,0,0,0,0,0,0,0,0
Chittagong,Cox's Bazar,Kutubdia,Uttar Dhurung,0,0,0,0,0,0,0,0,0
Chittagong,Cox's Bazar,Kutubdia,###,0,0,0,0,0,0,0,0,0
Chittagong,Cox's Bazar,###,###,59,30,29,3,26,7,15,5,3
Chittagong,Bandarban,Alikadam,Alikadam,0,0,0,0,0,0,0,0,0
Chittagong,Bandarban,Alikadam,Chokhyong,0,0,0,0,0,0,0,0,0
Chittagong,Bandarban,Alikadam,###,0,0,0,0,0,0,0,0,0
Chittagong,Bandarban,Rowangchhari,Alikhong,0,0,0,0,0,0,0,0,0
Chittagong,Bandarban,Rowangchhari,Nowa Patang,0,0,0,0,0,0,0,0,0
Chittagong,Bandarban,Rowangchhari,Rowangchhari,0,0,0,0,0,0,0,0,0
Chittagong,Bandarban,Rowangchhari,Tarachha,0,0,0,0,0,0,0,0,0
Chittagong,Bandarban,Rowangchhari,###,0,0,0,0,0,0,0,0,0
Chittagong,Bandarban,Lama,Aziznagar,0,0,0,0,0,0,0,0,0
Chittagong,Bandarban,Lama,Faitang,0,0,0,0,0,0,0,0,0
Chittagong,Bandarban,Lama,Fasyakhali,0,0,0,0,0,0,0,0,0
Chittagong,Bandarban,Lama,Gajalia,0,0,0,0,0,0,0,0,0
Chittagong,Bandarban,Lama,Lama,0,0,0,0,0,0,0,0,0
Chittagong,Bandarban,Lama,Lama Paurashava,0,0,0,0,0,0,0,0,0
Chittagong,Bandarban,Lama,Rupshipara,0,0,0,0,0,0,0,0,0
Chittagong,Bandarban,Lama,Sarai,0,0,0,0,0,0,0,0,0
Chittagong,Bandarban,Lama,###,0,0,0,0,0,0,0,0,0
Chittagong,Bandarban,Naikhongchhari,Baishari,0,0,0,0,0,0,0,0,0
Chittagong,Bandarban,Naikhongchhari,Dochhari,0,0,0,0,0,0,0,0,0
Chittagong,Bandarban,Naikhongchhari,Ghandung,0,0,0,0,0,0,0,0,0
Chittagong,Bandarban,Naikhongchhari,Naikhongchhari,0,0,0,0,0,0,0,0,0
Chittagong,Bandarban,Naikhongchhari,###,0,0,0,0,0,0,0,0,0
Chittagong,Bandarban,Thanchi,Balipara,0,0,0,0,0,0,0,0,0
Chittagong,Bandarban,Thanchi,Remakry,0,0,0,0,0,0,0,0,0
Chittagong,Bandarban,Thanchi,Thanchi,0,0,0,0,0,0,0,0,0
Chittagong,Bandarban,Thanchi,Tindu,0,0,0,0,0,0,0,0,0
Chittagong,Bandarban,Thanchi,###,0,0,0,0,0,0,0,0,0
Chittagong,Bandarban,Bandarban Sadar,Bandarban,0,0,0,0,0,0,0,0,0
Chittagong,Bandarban,Bandarban Sadar,Bandarban Paurashava,0,0,0,0,0,0,0,0,0
Chittagong,Bandarban,Bandarban Sadar,Kuhalong,0,0,0,0,0,0,0,0,0
Chittagong,Bandarban,Bandarban Sadar,Rajbila,0,0,0,0,0,0,0,0,0
Chittagong,Bandarban,Bandarban Sadar,Swalak,0,0,0,0,0,0,0,0,0
Chittagong,Bandarban,Bandarban Sadar,Tankabati,0,0,0,0,0,0,0,0,0
Chittagong,Bandarban,Bandarban Sadar,###,0,0,0,0,0,0,0,0,0
Chittagong,Bandarban,Ruma,Ghalangya,0,0,0,0,0,0,0,0,0
Chittagong,Bandarban,Ruma,Paindu,0,0,0,0,0,0,0,0,0
Chittagong,Bandarban,Ruma,Remakri Pransa,0,0,0,0,0,0,0,0,0
Chittagong,Bandarban,Ruma,Ruma,0,0,0,0,0,0,0,0,0
Chittagong,Bandarban,Ruma,###,0,0,0,0,0,0,0,0,0
Chittagong,Bandarban,###,###,0,0,0,0,0,0,0,0,0
Chittagong,###,###,###,45632,33783,11849,101,11748,111,28701,4320,651
Khulna,Khulna,Khulna Sadar,Ward No-31,5,0,5,0,5,0,0,0,0
Khulna,Khulna,Khulna Sadar,Ward No-21,3,1,2,0,2,0,0,0,1
Khulna,Khulna,Khulna Sadar,Ward No-29,3,0,3,0,3,0,0,0,0
Khulna,Khulna,Khulna Sadar,Ward No-24,1,0,1,0,1,0,0,0,0
Khulna,Khulna,Khulna Sadar,Ward No-27,1,0,1,0,1,0,0,0,0
Khulna,Khulna,Khulna Sadar,Ward No-22,0,0,0,0,0,0,0,0,0
Khulna,Khulna,Khulna Sadar,Ward No-23,0,0,0,0,0,0,0,0,0
Khulna,Khulna,Khulna Sadar,Ward No-28,0,0,0,0,0,0,0,0,0
Khulna,Khulna,Khulna Sadar,Ward No-30,0,0,0,0,0,0,0,0,0
Khulna,Khulna,Khulna Sadar,###,13,1,12,0,12,0,0,0,1
Khulna,Khulna,Sonadanga,Ward No-16,4,0,4,0,4,0,0,0,0
Khulna,Khulna,Sonadanga,Ward No-25,2,0,2,0,2,0,0,0,0
Khulna,Khulna,Sonadanga,Ward No-18,1,0,1,0,1,0,0,0,0
Khulna,Khulna,Sonadanga,Ward No-17,0,0,0,0,0,0,0,0,0
Khulna,Khulna,Sonadanga,Ward No-19,0,0,0,0,0,0,0,0,0
Khulna,Khulna,Sonadanga,Ward No-20,0,0,0,0,0,0,0,0,0
Khulna,Khulna,Sonadanga,Ward No-26,0,0,0,0,0,0,0,0,0
Khulna,Khulna,Sonadanga,###,7,0,7,0,7,0,0,0,0
Khulna,Khulna,Dumuria,Gutudia,1,0,1,0,1,0,0,0,0
Khulna,Khulna,Dumuria,Atlia,3,1,2,0,2,0,1,0,0
Khulna,Khulna,Dumuria,Kharnia,3,0,3,0,3,0,0,0,0
Khulna,Khulna,Dumuria,Raghunathpur,2,1,1,0,1,0,0,1,0
Khulna,Khulna,Dumuria,Sahas,2,1,1,0,1,0,1,0,0
Khulna,Khulna,Dumuria,Rudaghara,3,0,3,0,3,0,0,0,0
Khulna,Khulna,Dumuria,Dumuria,4,1,3,0,3,0,0,1,0
Khulna,Khulna,Dumuria,Sarappur,1,1,0,0,0,0,1,0,0
Khulna,Khulna,Dumuria,Maguraghona,1,1,0,0,0,0,0,1,0
Khulna,Khulna,Dumuria,Rangpur,1,0,1,0,1,0,0,0,0
Khulna,Khulna,Dumuria,Bhandar Para,0,0,0,0,0,0,0,0,0
Khulna,Khulna,Dumuria,Dhamalia,0,0,0,0,0,0,0,0,0
Khulna,Khulna,Dumuria,Magurkhali,0,0,0,0,0,0,0,0,0
Khulna,Khulna,Dumuria,Sobhana,0,0,0,0,0,0,0,0,0
Khulna,Khulna,Dumuria,###,21,6,15,0,15,0,3,3,0
Khulna,Khulna,Batiaghata,Baliadanga,3,0,3,0,3,0,0,0,0
Khulna,Khulna,Batiaghata,Amirpur,5,1,4,0,4,0,1,0,0
Khulna,Khulna,Batiaghata,Gangarampur,3,1,2,0,2,0,1,0,0
Khulna,Khulna,Batiaghata,Jalma,6,0,6,1,5,0,0,0,0
Khulna,Khulna,Batiaghata,Batiaghata,2,0,2,0,2,0,0,0,0
Khulna,Khulna,Batiaghata,Bhanderkote,0,0,0,0,0,0,0,0,0
Khulna,Khulna,Batiaghata,Surkhali,0,0,0,0,0,0,0,0,0
Khulna,Khulna,Batiaghata,###,19,2,17,1,16,0,2,0,0
Khulna,Khulna,Rupsa,Ghatbhogh,4,0,4,0,4,0,0,0,0
Khulna,Khulna,Rupsa,Naihati,8,2,6,0,6,0,1,0,1
Khulna,Khulna,Rupsa,Aijganti,2,2,0,0,0,0,0,2,0
Khulna,Khulna,Rupsa,Sreefaltala,4,1,3,0,3,0,0,0,1
Khulna,Khulna,Rupsa,T. S. Bahirdia,2,1,1,1,0,0,0,0,1
Khulna,Khulna,Rupsa,###,20,6,14,1,13,0,1,2,3
Khulna,Khulna,Terokhada,Sagladah,1,0,1,0,1,0,0,0,0
Khulna,Khulna,Terokhada,Madhupur,5,2,3,0,3,0,1,0,1
Khulna,Khulna,Terokhada,Barasat,3,2,1,0,1,0,2,0,0
Khulna,Khulna,Terokhada,Terokhada,1,1,0,0,0,0,1,0,0
Khulna,Khulna,Terokhada,Ajugara,0,0,0,0,0,0,0,0,0
Khulna,Khulna,Terokhada,Sachiadah,0,0,0,0,0,0,0,0,0
Khulna,Khulna,Terokhada,###,10,5,5,0,5,0,4,0,1
Khulna,Khulna,Koyra,Uttar Bedkashi,1,0,1,0,1,0,0,0,0
Khulna,Khulna,Koyra,Amadi,0,0,0,0,0,0,0,0,0
Khulna,Khulna,Koyra,Bagali,0,0,0,0,0,0,0,0,0
Khulna,Khulna,Koyra,Dakshin Bedkashi,0,0,0,0,0,0,0,0,0
Khulna,Khulna,Koyra,Koyra,0,0,0,0,0,0,0,0,0
Khulna,Khulna,Koyra,Maharajpur,0,0,0,0,0,0,0,0,0
Khulna,Khulna,Koyra,Maheshwaripur,0,0,0,0,0,0,0,0,0
Khulna,Khulna,Koyra,Nalian Range,0,0,0,0,0,0,0,0,0
Khulna,Khulna,Koyra,###,1,0,1,0,1,0,0,0,0
Khulna,Khulna,Phultala,Jamira,2,0,2,0,2,0,0,0,0
Khulna,Khulna,Phultala,Phultala,4,3,1,0,1,0,0,3,0
Khulna,Khulna,Phultala,Damodar,7,1,6,0,6,0,0,0,1
Khulna,Khulna,Phultala,###,13,4,9,0,9,0,0,3,1
Khulna,Khulna,Khalishpur,Ward No-08,3,0,3,1,2,0,0,0,0
Khulna,Khulna,Khalishpur,Ward No-07,1,0,1,1,0,0,0,0,0
Khulna,Khulna,Khalishpur,Ward No-14,2,1,1,0,1,0,0,0,1
Khulna,Khulna,Khalishpur,Ward No-11,1,1,0,0,0,0,0,1,0
Khulna,Khulna,Khalishpur,Ward No-15,4,0,4,0,4,0,0,0,0
Khulna,Khulna,Khalishpur,Ward No-12,1,1,0,0,0,0,1,0,0
Khulna,Khulna,Khalishpur,Ward No-09,0,0,0,0,0,0,0,0,0
Khulna,Khulna,Khalishpur,Ward No-10,0,0,0,0,0,0,0,0,0
Khulna,Khulna,Khalishpur,Ward No-13,0,0,0,0,0,0,0,0,0
Khulna,Khulna,Khalishpur,###,12,3,9,2,7,0,1,1,1
Khulna,Khulna,Daulatpur,Ward No-06,4,2,2,0,2,0,0,1,1
Khulna,Khulna,Daulatpur,Ward No-03,2,1,1,0,1,0,1,0,0
Khulna,Khulna,Daulatpur,Ward No-01,1,1,0,0,0,0,0,0,1
Khulna,Khulna,Daulatpur,Aranghata,2,1,1,0,1,0,0,1,0
Khulna,Khulna,Daulatpur,Ward No-02 (part),0,0,0,0,0,0,0,0,0
Khulna,Khulna,Daulatpur,Ward No-04,0,0,0,0,0,0,0,0,0
Khulna,Khulna,Daulatpur,Ward No-05,0,0,0,0,0,0,0,0,0
Khulna,Khulna,Daulatpur,###,9,5,4,0,4,0,1,2,2
Khulna,Khulna,Dighalia,Barakpur,3,2,1,0,1,0,0,2,0
Khulna,Khulna,Dighalia,Senhati,5,2,3,0,3,0,0,2,0
Khulna,Khulna,Dighalia,Dighalia,62,0,62,0,62,0,0,0,0
Khulna,Khulna,Dighalia,Gazir Hat,19,0,19,0,19,0,0,0,0
Khulna,Khulna,Dighalia,###,89,4,85,0,85,0,0,4,0
Khulna,Khulna,Khan Jahan Ali,Atra Gilatala,4,1,3,0,3,0,0,1,0
Khulna,Khulna,Khan Jahan Ali,Jugipole,2,2,0,0,0,0,0,2,0
Khulna,Khulna,Khan Jahan Ali,Ward No-02 (part),0,0,0,0,0,0,0,0,0
Khulna,Khulna,Khan Jahan Ali,###,6,3,3,0,3,0,0,3,0
Khulna,Khulna,Dacope,Pankhali,1,1,0,0,0,0,1,0,0
Khulna,Khulna,Dacope,Chalna Paurashava,1,1,0,0,0,0,1,0,0
Khulna,Khulna,Dacope,Bajua,2,1,1,0,1,0,1,0,0
Khulna,Khulna,Dacope,Banishanta,0,0,0,0,0,0,0,0,0
Khulna,Khulna,Dacope,Dacope,0,0,0,0,0,0,0,0,0
Khulna,Khulna,Dacope,Kailasganj,0,0,0,0,0,0,0,0,0
Khulna,Khulna,Dacope,Kamarkhola,0,0,0,0,0,0,0,0,0
Khulna,Khulna,Dacope,Khulna Range,0,0,0,0,0,0,0,0,0
Khulna,Khulna,Dacope,Laudubi,0,0,0,0,0,0,0,0,0
Khulna,Khulna,Dacope,Sutarkhali,0,0,0,0,0,0,0,0,0
Khulna,Khulna,Dacope,Tildanga,0,0,0,0,0,0,0,0,0
Khulna,Khulna,Dacope,###,4,3,1,0,1,0,3,0,0
Khulna,Khulna,Paikgachha,Kapilmuni,2,2,0,0,0,0,1,1,0
Khulna,Khulna,Paikgachha,Gadaipur,2,2,0,0,0,0,1,1,0
Khulna,Khulna,Paikgachha,Laskar,2,2,0,0,0,0,0,2,0
Khulna,Khulna,Paikgachha,Chandkhali,0,0,0,0,0,0,0,0,0
Khulna,Khulna,Paikgachha,Deluti,0,0,0,0,0,0,0,0,0
Khulna,Khulna,Paikgachha,Garuikhali,0,0,0,0,0,0,0,0,0
Khulna,Khulna,Paikgachha,Haridhali,0,0,0,0,0,0,0,0,0
Khulna,Khulna,Paikgachha,Lata,0,0,0,0,0,0,0,0,0
Khulna,Khulna,Paikgachha,Paikgachha Paurashava,0,0,0,0,0,0,0,0,0
Khulna,Khulna,Paikgachha,Raruli,0,0,0,0,0,0,0,0,0
Khulna,Khulna,Paikgachha,Sholadana,0,0,0,0,0,0,0,0,0
Khulna,Khulna,Paikgachha,###,6,6,0,0,0,0,2,4,0
Khulna,Khulna,###,###,230,48,182,4,178,0,17,22,9
Khulna,Narail,Narail Sadar,Auria,2,1,1,0,1,0,0,1,0
Khulna,Narail,Narail Sadar,Tularampur,3,1,2,0,2,0,0,1,0
Khulna,Narail,Narail Sadar,Maij Para Union,1,1,0,0,0,0,0,1,0
Khulna,Narail,Narail Sadar,Singasolpur,1,1,0,0,0,0,0,1,0
Khulna,Narail,Narail Sadar,Sahabad Union,1,1,0,0,0,0,0,1,0
Khulna,Narail,Narail Sadar,Kalora,1,1,0,0,0,0,0,1,0
Khulna,Narail,Narail Sadar,Narail Paurashava,2,2,0,0,0,0,0,1,1
Khulna,Narail,Narail Sadar,Mulia,1,1,0,0,0,0,0,1,0
Khulna,Narail,Narail Sadar,Banshgram,3,0,3,0,3,0,0,0,0
Khulna,Narail,Narail Sadar,Bhadrabila,0,0,0,0,0,0,0,0,0
Khulna,Narail,Narail Sadar,Bichhali,0,0,0,0,0,0,0,0,0
Khulna,Narail,Narail Sadar,Chandibarpur,0,0,0,0,0,0,0,0,0
Khulna,Narail,Narail Sadar,Habakhali,0,0,0,0,0,0,0,0,0
Khulna,Narail,Narail Sadar,Shaikhati,0,0,0,0,0,0,0,0,0
Khulna,Narail,Narail Sadar,###,15,9,6,0,6,0,0,8,1
Khulna,Narail,Lohagara,Mallikpur,1,0,1,0,1,0,0,0,0
Khulna,Narail,Lohagara,Kotakul,2,0,2,0,2,0,0,0,0
Khulna,Narail,Lohagara,Noagram,2,2,0,0,0,0,0,2,0
Khulna,Narail,Lohagara,Naldi,1,1,0,0,0,0,1,0,0
Khulna,Narail,Lohagara,Lahuria,1,1,0,0,0,0,0,1,0
Khulna,Narail,Lohagara,Lakshmipasha,1,1,0,0,0,0,0,1,0
Khulna,Narail,Lohagara,Dighalia,1,1,0,0,0,0,0,1,0
Khulna,Narail,Lohagara,Itna,0,0,0,0,0,0,0,0,0
Khulna,Narail,Lohagara,Joypur,0,0,0,0,0,0,0,0,0
Khulna,Narail,Lohagara,Kashipur,0,0,0,0,0,0,0,0,0
Khulna,Narail,Lohagara,Lohagara,0,0,0,0,0,0,0,0,0
Khulna,Narail,Lohagara,Lohagara Paurashava,0,0,0,0,0,0,0,0,0
Khulna,Narail,Lohagara,Shalnagar,0,0,0,0,0,0,0,0,0
Khulna,Narail,Lohagara,###,9,6,3,0,3,0,1,5,0
Khulna,Narail,Kalia,Kalabaria,2,1,1,0,1,0,0,1,0
Khulna,Narail,Kalia,Hamidpur,1,1,0,0,0,0,0,0,1
Khulna,Narail,Kalia,Purulia,1,1,0,0,0,0,0,1,0
Khulna,Narail,Kalia,Kalia Paurashava,3,1,2,0,2,0,0,1,0
Khulna,Narail,Kalia,Bauisena,1,1,0,0,0,0,1,0,0
Khulna,Narail,Kalia,Salamabad,1,1,0,0,0,0,1,0,0
Khulna,Narail,Kalia,Joynagar,1,1,0,0,0,0,0,1,0
Khulna,Narail,Kalia,Babra Hachla,1,1,0,0,0,0,0,1,0
Khulna,Narail,Kalia,Boranal Eliasabad,0,0,0,0,0,0,0,0,0
Khulna,Narail,Kalia,Chanchari,0,0,0,0,0,0,0,0,0
Khulna,Narail,Kalia,Khasial,0,0,0,0,0,0,0,0,0
Khulna,Narail,Kalia,Mauli,0,0,0,0,0,0,0,0,0
Khulna,Narail,Kalia,Pahardanga,0,0,0,0,0,0,0,0,0
Khulna,Narail,Kalia,Peruli,0,0,0,0,0,0,0,0,0
Khulna,Narail,Kalia,###,11,8,3,0,3,0,2,5,1
Khulna,Narail,###,###,35,23,12,0,12,0,3,18,2
Khulna,Jessore,Kotwali,Fathehpur,1,0,1,0,1,0,0,0,0
Khulna,Jessore,Kotwali,Diara,3,1,2,0,2,0,1,0,0
Khulna,Jessore,Kotwali,Basundia,8,0,8,0,8,0,0,0,0
Khulna,Jessore,Kotwali,Lebutala,3,1,2,0,2,0,0,1,0
Khulna,Jessore,Kotwali,Chanchra,3,1,2,0,2,0,0,1,0
Khulna,Jessore,Kotwali,Arabpur,2,0,2,0,2,0,0,0,0
Khulna,Jessore,Kotwali,Churamankati,5,1,4,0,4,0,0,1,0
Khulna,Jessore,Kotwali,Haibatpur,7,1,6,0,6,0,1,0,0
Khulna,Jessore,Kotwali,Kachua,3,0,3,0,3,0,0,0,0
Khulna,Jessore,Kotwali,Ramnagar,2,0,2,0,2,0,0,0,0
Khulna,Jessore,Kotwali,Narendrapur,3,1,2,0,2,0,0,1,0
Khulna,Jessore,Kotwali,Jessore Paurashava,5,3,2,2,0,0,0,3,0
Khulna,Jessore,Kotwali,Ichhali,1,1,0,0,0,0,0,1,0
Khulna,Jessore,Kotwali,Noapara,1,1,0,0,0,0,1,0,0
Khulna,Jessore,Kotwali,Kashimpur,0,0,0,0,0,0,0,0,0
Khulna,Jessore,Kotwali,Upasahar,0,0,0,0,0,0,0,0,0
Khulna,Jessore,Kotwali,###,47,11,36,2,34,0,3,8,0
Khulna,Jessore,Keshabpur,Keshabpur,20,0,20,0,20,0,0,0,0
Khulna,Jessore,Keshabpur,Majidpur,4,0,4,0,4,0,0,0,0
Khulna,Jessore,Keshabpur,Trimohini,2,1,1,0,1,0,1,0,0
Khulna,Jessore,Keshabpur,Bidyanandakati,12,1,11,0,11,0,1,0,0
Khulna,Jessore,Keshabpur,Gaurighona,11,1,10,0,10,0,0,1,0
Khulna,Jessore,Keshabpur,Keshabpur Paurashava,12,1,11,0,11,0,0,1,0
Khulna,Jessore,Keshabpur,Panjia,36,0,36,0,36,0,0,0,0
Khulna,Jessore,Keshabpur,Mangalkot,8,1,7,0,7,0,1,0,0
Khulna,Jessore,Keshabpur,Sufalakati,8,1,7,0,7,0,0,1,0
Khulna,Jessore,Keshabpur,Sagardari,5,1,4,0,4,0,0,1,0
Khulna,Jessore,Keshabpur,###,118,7,111,0,111,0,3,4,0
Khulna,Jessore,Abhaynagar,Prambag,8,1,7,0,7,0,0,1,0
Khulna,Jessore,Abhaynagar,Chalishia,2,0,2,0,2,0,0,0,0
Khulna,Jessore,Abhaynagar,Sreedharpur,4,2,2,0,2,0,0,2,0
Khulna,Jessore,Abhaynagar,Noapara Paurashava,2,1,1,1,0,0,0,1,0
Khulna,Jessore,Abhaynagar,Subha Para,1,1,0,0,0,0,1,0,0
Khulna,Jessore,Abhaynagar,Payra,1,1,0,0,0,0,1,0,0
Khulna,Jessore,Abhaynagar,Baghutia,0,0,0,0,0,0,0,0,0
Khulna,Jessore,Abhaynagar,Siddhipasha,0,0,0,0,0,0,0,0,0
Khulna,Jessore,Abhaynagar,Sundoli,0,0,0,0,0,0,0,0,0
Khulna,Jessore,Abhaynagar,###,18,6,12,1,11,0,2,4,0
Khulna,Jessore,Bagher Para,Narikelbaria,3,1,2,0,2,0,0,1,0
Khulna,Jessore,Bagher Para,Dohakula,4,1,3,0,3,0,0,1,0
Khulna,Jessore,Bagher Para,Bagher Para Paurashava,3,1,2,0,2,0,1,0,0
Khulna,Jessore,Bagher Para,Jamdia,2,2,0,0,0,0,0,2,0
Khulna,Jessore,Bagher Para,Roypur,1,1,0,0,0,0,0,1,0
Khulna,Jessore,Bagher Para,Jaharpur,1,1,0,0,0,0,0,1,0
Khulna,Jessore,Bagher Para,Dhalgram,1,1,0,0,0,0,0,1,0
Khulna,Jessore,Bagher Para,Bandabilla,0,0,0,0,0,0,0,0,0
Khulna,Jessore,Bagher Para,Basuari,0,0,0,0,0,0,0,0,0
Khulna,Jessore,Bagher Para,Darajhat,0,0,0,0,0,0,0,0,0
Khulna,Jessore,Bagher Para,###,15,8,7,0,7,0,1,7,0
Khulna,Jessore,Chaugachha,Jagadishpur,2,1,1,0,1,0,1,0,0
Khulna,Jessore,Chaugachha,Pashapole,2,0,2,0,2,0,0,0,0
Khulna,Jessore,Chaugachha,Phulsara,1,1,0,0,0,0,0,1,0
Khulna,Jessore,Chaugachha,Narayanpur,1,1,0,0,0,0,1,0,0
Khulna,Jessore,Chaugachha,Hakimpur,1,1,0,0,0,0,0,1,0
Khulna,Jessore,Chaugachha,Chaugachha Paurashava,2,1,1,1,0,0,0,1,0
Khulna,Jessore,Chaugachha,Swarupdaha,1,1,0,0,0,0,0,1,0
Khulna,Jessore,Chaugachha,Singhajhuli,2,2,0,0,0,0,1,1,0
Khulna,Jessore,Chaugachha,Chaugachha,0,0,0,0,0,0,0,0,0
Khulna,Jessore,Chaugachha,Dhuliani,0,0,0,0,0,0,0,0,0
Khulna,Jessore,Chaugachha,Patibila,0,0,0,0,0,0,0,0,0
Khulna,Jessore,Chaugachha,Sukpukhuria,0,0,0,0,0,0,0,0,0
Khulna,Jessore,Chaugachha,###,12,8,4,1,3,0,3,5,0
Khulna,Jessore,Manirampur,Kheda Para,11,1,10,0,10,0,1,0,0
Khulna,Jessore,Manirampur,Dhakuria,6,0,6,0,6,0,0,0,0
Khulna,Jessore,Manirampur,Kashimnagar,1,0,1,0,1,0,0,0,0
Khulna,Jessore,Manirampur,Bhojgati,2,1,1,0,1,0,0,1,0
Khulna,Jessore,Manirampur,Hariharnagar,7,1,6,0,6,0,1,0,0
Khulna,Jessore,Manirampur,Maswimnagar,14,1,13,0,13,0,1,0,0
Khulna,Jessore,Manirampur,Jhanpa,3,0,3,0,3,0,0,0,0
Khulna,Jessore,Manirampur,Rohita,2,1,1,0,1,0,0,1,0
Khulna,Jessore,Manirampur,Shyamkur,30,1,29,0,29,0,0,0,1
Khulna,Jessore,Manirampur,Manoharpur,8,1,7,0,7,0,1,0,0
Khulna,Jessore,Manirampur,Chaluahati,9,0,9,0,9,0,0,0,0
Khulna,Jessore,Manirampur,Durbadanga,13,0,13,0,13,0,0,0,0
Khulna,Jessore,Manirampur,Nehalpur,1,0,1,0,1,0,0,0,0
Khulna,Jessore,Manirampur,Khanpur,13,0,13,0,13,0,0,0,0
Khulna,Jessore,Manirampur,Haridaskati,4,1,3,0,3,0,1,0,0
Khulna,Jessore,Manirampur,Kultia,8,1,7,0,7,0,0,1,0
Khulna,Jessore,Manirampur,Manirampur,6,0,6,0,6,0,0,0,0
Khulna,Jessore,Manirampur,Manirampur Paurashava,8,0,8,0,8,0,0,0,0
Khulna,Jessore,Manirampur,###,146,9,137,0,137,0,5,3,1
Khulna,Jessore,Jhikargachha,Hajirbagh,10,1,9,0,9,0,1,0,0
Khulna,Jessore,Jhikargachha,Magura,28,1,27,0,27,0,0,1,0
Khulna,Jessore,Jhikargachha,Bankra,17,0,17,0,17,0,0,0,0
Khulna,Jessore,Jhikargachha,Nabharan,8,1,7,0,7,0,1,0,0
Khulna,Jessore,Jhikargachha,Shimulia,12,0,12,0,12,0,0,0,0
Khulna,Jessore,Jhikargachha,Jhikargachha,6,1,5,0,5,0,1,0,0
Khulna,Jessore,Jhikargachha,Ganganandapur,8,0,8,0,8,0,0,0,0
Khulna,Jessore,Jhikargachha,Jhikargachha Paurashava,2,0,2,1,1,0,0,0,0
Khulna,Jessore,Jhikargachha,Gadkhali,11,0,11,0,11,0,0,0,0
Khulna,Jessore,Jhikargachha,Panisara,1,0,1,0,1,0,0,0,0
Khulna,Jessore,Jhikargachha,Nibaskhola,7,0,7,0,7,0,0,0,0
Khulna,Jessore,Jhikargachha,Shankarpur,24,1,23,0,23,0,1,0,0
Khulna,Jessore,Jhikargachha,###,134,5,129,1,128,0,4,1,0
Khulna,Jessore,Sharsha,Sharsha,4,1,3,0,3,0,1,0,0
Khulna,Jessore,Sharsha,Bagachra,27,0,27,0,27,0,0,0,0
Khulna,Jessore,Sharsha,Kayba,10,1,9,0,9,0,1,0,0
Khulna,Jessore,Sharsha,Ulashi,2,1,1,0,1,0,1,0,0
Khulna,Jessore,Sharsha,Goga,1,0,1,0,1,0,0,0,0
Khulna,Jessore,Sharsha,Benapole Paurashava,1,1,0,0,0,0,1,0,0
Khulna,Jessore,Sharsha,Lakshmanpur,1,1,0,0,0,0,1,0,0
Khulna,Jessore,Sharsha,Putkhali,1,1,0,0,0,0,1,0,0
Khulna,Jessore,Sharsha,Nizampur,1,1,0,0,0,0,1,0,0
Khulna,Jessore,Sharsha,Bahadurpur,0,0,0,0,0,0,0,0,0
Khulna,Jessore,Sharsha,Benapole,0,0,0,0,0,0,0,0,0
Khulna,Jessore,Sharsha,Dihi,0,0,0,0,0,0,0,0,0
Khulna,Jessore,Sharsha,###,48,7,41,0,41,0,7,0,0
Khulna,Jessore,###,###,538,61,477,5,472,0,28,32,1
Khulna,Bagerhat,Bagerhat Sadar,Kara Para,5,1,4,0,4,0,1,0,0
Khulna,Bagerhat,Bagerhat Sadar,Gota Para,1,0,1,0,1,0,0,0,0
Khulna,Bagerhat,Bagerhat Sadar,Shat Gambuj,1,0,1,0,1,0,0,0,0
Khulna,Bagerhat,Bagerhat Sadar,Rakhalgachhi,7,2,5,0,5,1,1,0,0
Khulna,Bagerhat,Bagerhat Sadar,Khanpur,2,0,2,0,2,0,0,0,0
Khulna,Bagerhat,Bagerhat Sadar,Bagerhat Paurashava,2,2,0,0,0,0,2,0,0
Khulna,Bagerhat,Bagerhat Sadar,Jatrapur,1,1,0,0,0,0,1,0,0
Khulna,Bagerhat,Bagerhat Sadar,Bemarta,1,1,0,0,0,0,1,0,0
Khulna,Bagerhat,Bagerhat Sadar,Barai Para,0,0,0,0,0,0,0,0,0
Khulna,Bagerhat,Bagerhat Sadar,Bishnupur,0,0,0,0,0,0,0,0,0
Khulna,Bagerhat,Bagerhat Sadar,Dema,0,0,0,0,0,0,0,0,0
Khulna,Bagerhat,Bagerhat Sadar,###,20,7,13,0,13,1,6,0,0
Khulna,Bagerhat,Kachua,Rari Para,3,2,1,0,1,1,1,0,0
Khulna,Bagerhat,Kachua,Badhal,1,1,0,0,0,0,1,0,0
Khulna,Bagerhat,Kachua,Dhopakhali,2,2,0,0,0,1,1,0,0
Khulna,Bagerhat,Kachua,Kachua,1,1,0,0,0,0,1,0,0
Khulna,Bagerhat,Kachua,Maghia,1,1,0,0,0,0,1,0,0
Khulna,Bagerhat,Kachua,Gazalia,0,0,0,0,0,0,0,0,0
Khulna,Bagerhat,Kachua,Gopalpur,0,0,0,0,0,0,0,0,0
Khulna,Bagerhat,Kachua,###,8,7,1,0,1,2,5,0,0
Khulna,Bagerhat,Rampal,Rampal,5,2,3,0,3,1,1,0,0
Khulna,Bagerhat,Rampal,Baintala,1,0,1,0,1,0,0,0,0
Khulna,Bagerhat,Rampal,Banshtali,1,1,0,0,0,1,0,0,0
Khulna,Bagerhat,Rampal,Ujalkur,2,2,0,0,0,0,2,0,0
Khulna,Bagerhat,Rampal,Gaurambha,1,1,0,0,0,0,1,0,0
Khulna,Bagerhat,Rampal,Perikhali,1,1,0,0,0,0,1,0,0
Khulna,Bagerhat,Rampal,Bhojpatia,0,0,0,0,0,0,0,0,0
Khulna,Bagerhat,Rampal,Hurka,0,0,0,0,0,0,0,0,0
Khulna,Bagerhat,Rampal,Malliker Ber,0,0,0,0,0,0,0,0,0
Khulna,Bagerhat,Rampal,Rajnagar,0,0,0,0,0,0,0,0,0
Khulna,Bagerhat,Rampal,###,11,7,4,0,4,2,5,0,0
Khulna,Bagerhat,Mollahat,Kulia,5,2,3,0,3,0,2,0,0
Khulna,Bagerhat,Mollahat,Kodalia,1,1,0,0,0,0,1,0,0
Khulna,Bagerhat,Mollahat,Udaypur,1,1,0,0,0,0,1,0,0
Khulna,Bagerhat,Mollahat,Gaola,1,1,0,0,0,0,1,0,0
Khulna,Bagerhat,Mollahat,Atjuri,1,1,0,0,0,0,1,0,0
Khulna,Bagerhat,Mollahat,Chunkhola,0,0,0,0,0,0,0,0,0
Khulna,Bagerhat,Mollahat,Gangni,0,0,0,0,0,0,0,0,0
Khulna,Bagerhat,Mollahat,###,9,6,3,0,3,0,6,0,0
Khulna,Bagerhat,Chitalmari,Bara Baria,2,1,1,0,1,0,1,0,0
Khulna,Bagerhat,Chitalmari,Kalatala,2,1,1,0,1,0,1,0,0
Khulna,Bagerhat,Chitalmari,Hizla,4,4,0,0,0,0,4,0,0
Khulna,Bagerhat,Chitalmari,Santoshpur,2,2,0,0,0,0,1,1,0
Khulna,Bagerhat,Chitalmari,Char Baniari,1,1,0,0,0,0,1,0,0
Khulna,Bagerhat,Chitalmari,Chitalmari,0,0,0,0,0,0,0,0,0
Khulna,Bagerhat,Chitalmari,Shibpur,0,0,0,0,0,0,0,0,0
Khulna,Bagerhat,Chitalmari,###,11,9,2,0,2,0,8,1,0
Khulna,Bagerhat,Fakirhat,Bahirdia Mansa,4,1,3,0,3,0,1,0,0
Khulna,Bagerhat,Fakirhat,Subhadia,2,2,0,0,0,0,1,1,0
Khulna,Bagerhat,Fakirhat,Betaga,1,1,0,0,0,0,1,0,0
Khulna,Bagerhat,Fakirhat,Mulghar,1,1,0,0,0,0,1,0,0
Khulna,Bagerhat,Fakirhat,Piljanga,1,1,0,0,0,0,1,0,0
Khulna,Bagerhat,Fakirhat,Fakirhat,1,1,0,0,0,0,1,0,0
Khulna,Bagerhat,Fakirhat,Lakhpur,0,0,0,0,0,0,0,0,0
Khulna,Bagerhat,Fakirhat,Naldha Maubhog,0,0,0,0,0,0,0,0,0
Khulna,Bagerhat,Fakirhat,###,10,7,3,0,3,0,6,1,0
Khulna,Bagerhat,Mongla,Burirdanga,3,2,1,0,1,1,1,0,0
Khulna,Bagerhat,Mongla,Mongla Port Paurashava,2,2,0,0,0,1,1,0,0
Khulna,Bagerhat,Mongla,Chandpai Range,0,0,0,0,0,0,0,0,0
Khulna,Bagerhat,Mongla,Chandpi,0,0,0,0,0,0,0,0,0
Khulna,Bagerhat,Mongla,Chila,0,0,0,0,0,0,0,0,0
Khulna,Bagerhat,Mongla,Mithakhali,0,0,0,0,0,0,0,0,0
Khulna,Bagerhat,Mongla,Sundarban,0,0,0,0,0,0,0,0,0
Khulna,Bagerhat,Mongla,Suniltala,0,0,0,0,0,0,0,0,0
Khulna,Bagerhat,Mongla,###,5,4,1,0,1,2,2,0,0
Khulna,Bagerhat,Sarankhola,Dakshin Khali Union,1,1,0,0,0,1,0,0,0
Khulna,Bagerhat,Sarankhola,Royenda,3,3,0,0,0,3,0,0,0
Khulna,Bagerhat,Sarankhola,Dhansagar,0,0,0,0,0,0,0,0,0
Khulna,Bagerhat,Sarankhola,Khontakata,0,0,0,0,0,0,0,0,0
Khulna,Bagerhat,Sarankhola,Sharankhola Range,0,0,0,0,0,0,0,0,0
Khulna,Bagerhat,Sarankhola,###,4,4,0,0,0,4,0,0,0
Khulna,Bagerhat,Morrelganj,Balaibunia,1,1,0,0,0,0,1,0,0
Khulna,Bagerhat,Morrelganj,Hogla Pasha,1,1,0,0,0,0,1,0,0
Khulna,Bagerhat,Morrelganj,Morrelganj Paurashava,1,1,0,0,0,1,0,0,0
Khulna,Bagerhat,Morrelganj,Daibagnyahati,1,1,0,0,0,0,1,0,0
Khulna,Bagerhat,Morrelganj,Teligati,1,1,0,0,0,0,1,0,0
Khulna,Bagerhat,Morrelganj,Banagram,1,1,0,0,0,0,1,0,0
Khulna,Bagerhat,Morrelganj,Baharbunia,0,0,0,0,0,0,0,0,0
Khulna,Bagerhat,Morrelganj,Baraikhali,0,0,0,0,0,0,0,0,0
Khulna,Bagerhat,Morrelganj,Chingrakhali,0,0,0,0,0,0,0,0,0
Khulna,Bagerhat,Morrelganj,Hoglabunia,0,0,0,0,0,0,0,0,0
Khulna,Bagerhat,Morrelganj,Jiudhara,0,0,0,0,0,0,0,0,0
Khulna,Bagerhat,Morrelganj,Khuolia,0,0,0,0,0,0,0,0,0
Khulna,Bagerhat,Morrelganj,Morrelganj,0,0,0,0,0,0,0,0,0
Khulna,Bagerhat,Morrelganj,Nishanbaria,0,0,0,0,0,0,0,0,0
Khulna,Bagerhat,Morrelganj,Panchakaran,0,0,0,0,0,0,0,0,0
Khulna,Bagerhat,Morrelganj,Putikhali,0,0,0,0,0,0,0,0,0
Khulna,Bagerhat,Morrelganj,Ramchandrapur,0,0,0,0,0,0,0,0,0
Khulna,Bagerhat,Morrelganj,###,6,6,0,0,0,1,5,0,0
Khulna,Bagerhat,###,###,84,57,27,0,27,12,43,2,0
Khulna,Satkhira,Tala,Sarulia,2,1,1,0,1,0,1,0,0
Khulna,Satkhira,Tala,Islamkati,2,1,1,0,1,0,0,1,0
Khulna,Satkhira,Tala,Tentulia,3,1,2,0,2,0,0,1,0
Khulna,Satkhira,Tala,Khalilnagar,1,1,0,0,0,0,0,1,0
Khulna,Satkhira,Tala,Tala,1,1,0,0,0,0,1,0,0
Khulna,Satkhira,Tala,Khesra,1,1,0,0,0,0,1,0,0
Khulna,Satkhira,Tala,Magura,1,1,0,0,0,0,0,1,0
Khulna,Satkhira,Tala,Dhandia,1,1,0,0,0,0,1,0,0
Khulna,Satkhira,Tala,Jalalpur,0,0,0,0,0,0,0,0,0
Khulna,Satkhira,Tala,Khalishkhali,0,0,0,0,0,0,0,0,0
Khulna,Satkhira,Tala,Kumira,0,0,0,0,0,0,0,0,0
Khulna,Satkhira,Tala,Nagarghata,0,0,0,0,0,0,0,0,0
Khulna,Satkhira,Tala,###,12,8,4,0,4,0,4,4,0
Khulna,Satkhira,Kaliganj,Dhalbaria,7,1,6,0,6,0,1,0,0
Khulna,Satkhira,Kaliganj,Krishnanagar,3,0,3,0,3,0,0,0,0
Khulna,Satkhira,Kaliganj,Bishnupur,1,1,0,0,0,0,1,0,0
Khulna,Satkhira,Kaliganj,Mathureshpur,1,1,0,0,0,1,0,0,0
Khulna,Satkhira,Kaliganj,Ratanpur,1,1,0,0,0,1,0,0,0
Khulna,Satkhira,Kaliganj,Tarali,1,1,0,0,0,1,0,0,0
Khulna,Satkhira,Kaliganj,Bhara Simla,1,1,0,0,0,0,1,0,0
Khulna,Satkhira,Kaliganj,Nalta,1,1,0,0,0,0,1,0,0
Khulna,Satkhira,Kaliganj,Dakshin Sreepur,1,0,1,0,1,0,0,0,0
Khulna,Satkhira,Kaliganj,Champaphul,0,0,0,0,0,0,0,0,0
Khulna,Satkhira,Kaliganj,Kushlia,0,0,0,0,0,0,0,0,0
Khulna,Satkhira,Kaliganj,Mautala,0,0,0,0,0,0,0,0,0
Khulna,Satkhira,Kaliganj,###,17,7,10,0,10,3,4,0,0
Khulna,Satkhira,Satkhira Sadar,Bhomra,3,0,3,0,3,0,0,0,0
Khulna,Satkhira,Satkhira Sadar,Dhulihar,5,0,5,0,5,0,0,0,0
Khulna,Satkhira,Satkhira Sadar,Labsa,1,0,1,0,1,0,0,0,0
Khulna,Satkhira,Satkhira Sadar,Alipur,4,2,2,0,2,0,2,0,0
Khulna,Satkhira,Satkhira Sadar,Satkhira Paurashava,3,2,1,0,1,0,2,0,0
Khulna,Satkhira,Satkhira Sadar,Fingri,1,1,0,0,0,1,0,0,0
Khulna,Satkhira,Satkhira Sadar,Brahma Rajpur,2,2,0,0,0,0,2,0,0
Khulna,Satkhira,Satkhira Sadar,Shibpur,1,1,0,0,0,0,1,0,0
Khulna,Satkhira,Satkhira Sadar,Jhaudanga,1,1,0,0,0,0,1,0,0
Khulna,Satkhira,Satkhira Sadar,Baikari,2,1,1,1,0,0,1,0,0
Khulna,Satkhira,Satkhira Sadar,Banshdaha,1,1,0,0,0,0,1,0,0
Khulna,Satkhira,Satkhira Sadar,Agardari,0,0,0,0,0,0,0,0,0
Khulna,Satkhira,Satkhira Sadar,Balli,0,0,0,0,0,0,0,0,0
Khulna,Satkhira,Satkhira Sadar,Ghona,0,0,0,0,0,0,0,0,0
Khulna,Satkhira,Satkhira Sadar,Kuskhali,0,0,0,0,0,0,0,0,0
Khulna,Satkhira,Satkhira Sadar,###,24,11,13,1,12,1,10,0,0
Khulna,Satkhira,Kalaroa,Diara,4,1,3,0,3,0,1,0,0
Khulna,Satkhira,Kalaroa,Chandanpur,1,1,0,0,0,0,0,1,0
Khulna,Satkhira,Kalaroa,Keralkata,1,1,0,0,0,0,1,0,0
Khulna,Satkhira,Kalaroa,Kalaroa Paurashava,3,1,2,2,0,0,1,0,0
Khulna,Satkhira,Kalaroa,Jogikhali,1,1,0,0,0,0,1,0,0
Khulna,Satkhira,Kalaroa,Sonabaria,1,1,0,0,0,0,0,1,0
Khulna,Satkhira,Kalaroa,Keragachhi,1,1,0,0,0,0,0,1,0
Khulna,Satkhira,Kalaroa,Helatala,0,0,0,0,0,0,0,0,0
Khulna,Satkhira,Kalaroa,Jallabad,0,0,0,0,0,0,0,0,0
Khulna,Satkhira,Kalaroa,Joynagar,0,0,0,0,0,0,0,0,0
Khulna,Satkhira,Kalaroa,Kaila,0,0,0,0,0,0,0,0,0
Khulna,Satkhira,Kalaroa,Kushadanga,0,0,0,0,0,0,0,0,0
Khulna,Satkhira,Kalaroa,Nangalthara,0,0,0,0,0,0,0,0,0
Khulna,Satkhira,Kalaroa,###,12,7,5,2,3,0,4,3,0
Khulna,Satkhira,Shyamnagar,Kashimari,3,0,3,0,3,0,0,0,0
Khulna,Satkhira,Shyamnagar,Gabura,2,0,2,0,2,0,0,0,0
Khulna,Satkhira,Shyamnagar,Atulia,1,0,1,0,1,0,0,0,0
Khulna,Satkhira,Shyamnagar,Ishwaripur,2,2,0,0,0,1,1,0,0
Khulna,Satkhira,Shyamnagar,Shyamnagar,1,1,0,0,0,1,0,0,0
Khulna,Satkhira,Shyamnagar,Bhurulia,2,2,0,0,0,2,0,0,0
Khulna,Satkhira,Shyamnagar,Nurnagar,1,1,0,0,0,1,0,0,0
Khulna,Satkhira,Shyamnagar,Buri Goalini,0,0,0,0,0,0,0,0,0
Khulna,Satkhira,Shyamnagar,Kaikhali,0,0,0,0,0,0,0,0,0
Khulna,Satkhira,Shyamnagar,Munshiganj,0,0,0,0,0,0,0,0,0
Khulna,Satkhira,Shyamnagar,Padma Pukur,0,0,0,0,0,0,0,0,0
Khulna,Satkhira,Shyamnagar,Ramjan Nagar,0,0,0,0,0,0,0,0,0
Khulna,Satkhira,Shyamnagar,Satkhira Range,0,0,0,0,0,0,0,0,0
Khulna,Satkhira,Shyamnagar,###,12,6,6,0,6,5,1,0,0
Khulna,Satkhira,Assasuni,Sobhnali,3,1,2,0,2,1,0,0,0
Khulna,Satkhira,Assasuni,Baradal,1,1,0,0,0,0,0,1,0
Khulna,Satkhira,Assasuni,Budhhata,1,1,0,0,0,0,0,1,0
Khulna,Satkhira,Assasuni,Anulia,1,1,0,0,0,0,0,1,0
Khulna,Satkhira,Assasuni,Khajra,1,1,0,0,0,0,0,1,0
Khulna,Satkhira,Assasuni,Assasuni,0,0,0,0,0,0,0,0,0
Khulna,Satkhira,Assasuni,Durgapur,0,0,0,0,0,0,0,0,0
Khulna,Satkhira,Assasuni,Kadakati,0,0,0,0,0,0,0,0,0
Khulna,Satkhira,Assasuni,Kulla,0,0,0,0,0,0,0,0,0
Khulna,Satkhira,Assasuni,Pratap Nagar,0,0,0,0,0,0,0,0,0
Khulna,Satkhira,Assasuni,Sreeula,0,0,0,0,0,0,0,0,0
Khulna,Satkhira,Assasuni,###,7,5,2,0,2,1,0,4,0
Khulna,Satkhira,Debhata,Parulia,45,2,43,0,43,0,1,1,0
Khulna,Satkhira,Debhata,Sakhipur,11,2,9,0,9,0,2,0,0
Khulna,Satkhira,Debhata,Kulia,37,1,36,0,36,0,1,0,0
Khulna,Satkhira,Debhata,Noapara,11,1,10,0,10,0,1,0,0
Khulna,Satkhira,Debhata,Debhata,11,1,10,0,10,0,0,1,0
Khulna,Satkhira,Debhata,###,115,7,108,0,108,0,5,2,0
Khulna,Satkhira,###,###,199,51,148,3,145,10,28,13,0
Khulna,Magura,Mohammadpur,Digha,3,1,2,0,2,0,0,0,1
Khulna,Magura,Mohammadpur,Mohammadpur,10,1,9,1,8,0,0,0,1
Khulna,Magura,Mohammadpur,Binodepur,8,1,7,0,7,0,0,1,0
Khulna,Magura,Mohammadpur,Nahata,1,1,0,0,0,0,0,1,0
Khulna,Magura,Mohammadpur,Babukhali,1,1,0,0,0,0,0,1,0
Khulna,Magura,Mohammadpur,Palashbaria,1,1,0,0,0,0,0,1,0
Khulna,Magura,Mohammadpur,Balidia,1,1,0,0,0,0,0,1,0
Khulna,Magura,Mohammadpur,Rajapur,0,0,0,0,0,0,0,0,0
Khulna,Magura,Mohammadpur,###,25,7,18,1,17,0,0,5,2
Khulna,Magura,Sreepur,Gayeshpur,3,1,2,0,2,0,1,0,0
Khulna,Magura,Sreepur,Amalsar,1,1,0,0,0,0,0,1,0
Khulna,Magura,Sreepur,Sreekol,1,1,0,0,0,0,0,1,0
Khulna,Magura,Sreepur,Nakol,1,1,0,0,0,0,1,0,0
Khulna,Magura,Sreepur,Sabdalpur,1,1,0,0,0,0,0,1,0
Khulna,Magura,Sreepur,Sreepur,1,1,0,0,0,0,0,1,0
Khulna,Magura,Sreepur,Dariapur,0,0,0,0,0,0,0,0,0
Khulna,Magura,Sreepur,Kadir Para,0,0,0,0,0,0,0,0,0
Khulna,Magura,Sreepur,###,8,6,2,0,2,0,2,4,0
Khulna,Magura,Shalikha,Talkhari,1,1,0,0,0,0,0,1,0
Khulna,Magura,Shalikha,Shalikha,1,1,0,0,0,0,0,1,0
Khulna,Magura,Shalikha,Bunagati,1,1,0,0,0,0,0,1,0
Khulna,Magura,Shalikha,Dhaneshwargati,1,1,0,0,0,0,0,1,0
Khulna,Magura,Shalikha,Shatakhali,1,1,0,0,0,0,0,1,0
Khulna,Magura,Shalikha,Arpara,2,1,1,1,0,0,0,1,0
Khulna,Magura,Shalikha,Gangarampur,0,0,0,0,0,0,0,0,0
Khulna,Magura,Shalikha,###,7,6,1,1,0,0,0,6,0
Khulna,Magura,Magura Sadar,Magura Paurashava,6,4,2,2,0,0,1,3,0
Khulna,Magura,Magura Sadar,Chaulia,2,2,0,0,0,0,0,2,0
Khulna,Magura,Magura Sadar,Satrujitpur,1,1,0,0,0,0,0,1,0
Khulna,Magura,Magura Sadar,Birail Palita,1,1,0,0,0,0,0,1,0
Khulna,Magura,Magura Sadar,Hazrapur,1,1,0,0,0,0,0,1,0
Khulna,Magura,Magura Sadar,Jagdal,1,1,0,0,0,0,0,1,0
Khulna,Magura,Magura Sadar,Atharakhada,0,0,0,0,0,0,0,0,0
Khulna,Magura,Magura Sadar,Bagia,0,0,0,0,0,0,0,0,0
Khulna,Magura,Magura Sadar,Gopalgram,0,0,0,0,0,0,0,0,0
Khulna,Magura,Magura Sadar,Hazipur,0,0,0,0,0,0,0,0,0
Khulna,Magura,Magura Sadar,Kasundi,0,0,0,0,0,0,0,0,0
Khulna,Magura,Magura Sadar,Kuchiamora,0,0,0,0,0,0,0,0,0
Khulna,Magura,Magura Sadar,Maghi,0,0,0,0,0,0,0,0,0
Khulna,Magura,Magura Sadar,Raghab Dair,0,0,0,0,0,0,0,0,0
Khulna,Magura,Magura Sadar,###,12,10,2,2,0,0,1,9,0
Khulna,Magura,###,###,52,29,23,4,19,0,3,24,2
Khulna,Jhenaidah,Harinakunda,Harinakunda Paurashava,2,2,0,0,0,0,0,1,1
Khulna,Jhenaidah,Harinakunda,Raghunathpur,1,1,0,0,0,0,0,1,0
Khulna,Jhenaidah,Harinakunda,Chandpur,1,1,0,0,0,0,1,0,0
Khulna,Jhenaidah,Harinakunda,Joradaha,1,1,0,0,0,0,1,0,0
Khulna,Jhenaidah,Harinakunda,Daulatpur,1,1,0,0,0,0,1,0,0
Khulna,Jhenaidah,Harinakunda,Kapashati,1,1,0,0,0,0,0,1,0
Khulna,Jhenaidah,Harinakunda,Bhayna,0,0,0,0,0,0,0,0,0
Khulna,Jhenaidah,Harinakunda,Palsi,0,0,0,0,0,0,0,0,0
Khulna,Jhenaidah,Harinakunda,Taherhuda,0,0,0,0,0,0,0,0,0
Khulna,Jhenaidah,Harinakunda,###,7,7,0,0,0,0,3,3,1
Khulna,Jhenaidah,Kaliganj,Trilochanpur,1,1,0,0,0,0,0,1,0
Khulna,Jhenaidah,Kaliganj,Rakhalgachhi,1,1,0,0,0,0,0,1,0
Khulna,Jhenaidah,Kaliganj,Roygram,1,1,0,0,0,0,0,1,0
Khulna,Jhenaidah,Kaliganj,Kaliganj Paurashava,2,1,1,1,0,0,0,1,0
Khulna,Jhenaidah,Kaliganj,Maliat,1,1,0,0,0,0,0,1,0
Khulna,Jhenaidah,Kaliganj,Kola,1,1,0,0,0,0,0,1,0
Khulna,Jhenaidah,Kaliganj,Bara Bazar,1,1,0,0,0,0,0,1,0
Khulna,Jhenaidah,Kaliganj,Jamal,0,0,0,0,0,0,0,0,0
Khulna,Jhenaidah,Kaliganj,Kashtabhanga,0,0,0,0,0,0,0,0,0
Khulna,Jhenaidah,Kaliganj,Niamatpur,0,0,0,0,0,0,0,0,0
Khulna,Jhenaidah,Kaliganj,Simla Rokonpur,0,0,0,0,0,0,0,0,0
Khulna,Jhenaidah,Kaliganj,Sundarpur Durgapur,0,0,0,0,0,0,0,0,0
Khulna,Jhenaidah,Kaliganj,###,8,7,1,1,0,0,0,7,0
Khulna,Jhenaidah,Kotchandpur,Kushna,1,1,0,0,0,0,0,1,0
Khulna,Jhenaidah,Kotchandpur,Kotchandpur Paurashava,2,1,1,1,0,0,1,0,0
Khulna,Jhenaidah,Kotchandpur,Sabdalpur,2,2,0,0,0,0,0,2,0
Khulna,Jhenaidah,Kotchandpur,Elangi,1,1,0,0,0,0,0,1,0
Khulna,Jhenaidah,Kotchandpur,Baluhar,1,1,0,0,0,0,1,0,0
Khulna,Jhenaidah,Kotchandpur,Dora,1,1,0,0,0,0,1,0,0
Khulna,Jhenaidah,Kotchandpur,###,8,7,1,1,0,0,3,4,0
Khulna,Jhenaidah,Shailkupa,Sarutia,1,1,0,0,0,0,0,1,0
Khulna,Jhenaidah,Shailkupa,Shailkupa Paurashava,3,1,2,0,2,0,1,0,0
Khulna,Jhenaidah,Shailkupa,Umedpur,1,1,0,0,0,0,1,0,0
Khulna,Jhenaidah,Shailkupa,Kancherkol,1,1,0,0,0,0,0,1,0
Khulna,Jhenaidah,Shailkupa,Mirzapur,1,1,0,0,0,0,1,0,0
Khulna,Jhenaidah,Shailkupa,Tribeni,1,1,0,0,0,0,0,1,0
Khulna,Jhenaidah,Shailkupa,Dhalhara Chandra,1,1,0,0,0,0,0,1,0
Khulna,Jhenaidah,Shailkupa,Dudhsar,1,1,0,0,0,0,0,1,0
Khulna,Jhenaidah,Shailkupa,Dignagar,1,1,0,0,0,0,0,1,0
Khulna,Jhenaidah,Shailkupa,Abaipur,0,0,0,0,0,0,0,0,0
Khulna,Jhenaidah,Shailkupa,Bagura,0,0,0,0,0,0,0,0,0
Khulna,Jhenaidah,Shailkupa,Fulhari,0,0,0,0,0,0,0,0,0
Khulna,Jhenaidah,Shailkupa,Hakimpur,0,0,0,0,0,0,0,0,0
Khulna,Jhenaidah,Shailkupa,Manoharpur,0,0,0,0,0,0,0,0,0
Khulna,Jhenaidah,Shailkupa,Nityanandapur,0,0,0,0,0,0,0,0,0
Khulna,Jhenaidah,Shailkupa,###,11,9,2,0,2,0,3,6,0
Khulna,Jhenaidah,Jhenaidah Sadar,Saganna,2,2,0,0,0,0,1,1,0
Khulna,Jhenaidah,Jhenaidah Sadar,Ghorshal,1,1,0,0,0,0,0,1,0
Khulna,Jhenaidah,Jhenaidah Sadar,Moharajpur,1,1,0,0,0,0,0,1,0
Khulna,Jhenaidah,Jhenaidah Sadar,Fursandi,1,1,0,0,0,0,1,0,0
Khulna,Jhenaidah,Jhenaidah Sadar,Jhenaidah Paurashava,2,1,1,1,0,0,0,1,0
Khulna,Jhenaidah,Jhenaidah Sadar,Halidhani,1,1,0,0,0,0,1,0,0
Khulna,Jhenaidah,Jhenaidah Sadar,Harishankarpur,1,1,0,0,0,0,1,0,0
Khulna,Jhenaidah,Jhenaidah Sadar,Madhuhati,1,1,0,0,0,0,0,1,0
Khulna,Jhenaidah,Jhenaidah Sadar,Porahati,1,1,0,0,0,0,1,0,0
Khulna,Jhenaidah,Jhenaidah Sadar,Padmakar,1,1,0,0,0,0,0,1,0
Khulna,Jhenaidah,Jhenaidah Sadar,Dogachhi,0,0,0,0,0,0,0,0,0
Khulna,Jhenaidah,Jhenaidah Sadar,Ganna,0,0,0,0,0,0,0,0,0
Khulna,Jhenaidah,Jhenaidah Sadar,Kalicharanpur,0,0,0,0,0,0,0,0,0
Khulna,Jhenaidah,Jhenaidah Sadar,Kumrabaria,0,0,0,0,0,0,0,0,0
Khulna,Jhenaidah,Jhenaidah Sadar,Naldanga,0,0,0,0,0,0,0,0,0
Khulna,Jhenaidah,Jhenaidah Sadar,Paglakanai,0,0,0,0,0,0,0,0,0
Khulna,Jhenaidah,Jhenaidah Sadar,Sadhuhati,0,0,0,0,0,0,0,0,0
Khulna,Jhenaidah,Jhenaidah Sadar,Surat,0,0,0,0,0,0,0,0,0
Khulna,Jhenaidah,Jhenaidah Sadar,###,12,11,1,1,0,0,5,6,0
Khulna,Jhenaidah,Maheshpur,Maheshpur Paurashava,2,1,1,1,0,0,1,0,0
Khulna,Jhenaidah,Maheshpur,Swaruppur,1,1,0,0,0,0,1,0,0
Khulna,Jhenaidah,Maheshpur,Kazirber,1,1,0,0,0,0,1,0,0
Khulna,Jhenaidah,Maheshpur,Banshbaria,1,1,0,0,0,0,1,0,0
Khulna,Jhenaidah,Maheshpur,Jadabpur,1,1,0,0,0,0,1,0,0
Khulna,Jhenaidah,Maheshpur,Manderbari,1,1,0,0,0,0,1,0,0
Khulna,Jhenaidah,Maheshpur,S.k.b.(sundarpur),1,1,0,0,0,0,1,0,0
Khulna,Jhenaidah,Maheshpur,Nepa,1,1,0,0,0,0,1,0,0
Khulna,Jhenaidah,Maheshpur,Fatehpur,1,1,0,0,0,0,0,1,0
Khulna,Jhenaidah,Maheshpur,Azampur,0,0,0,0,0,0,0,0,0
Khulna,Jhenaidah,Maheshpur,Natima,0,0,0,0,0,0,0,0,0
Khulna,Jhenaidah,Maheshpur,Pantha Para,0,0,0,0,0,0,0,0,0
Khulna,Jhenaidah,Maheshpur,Shyamkur,0,0,0,0,0,0,0,0,0
Khulna,Jhenaidah,Maheshpur,###,10,9,1,1,0,0,8,1,0
Khulna,Jhenaidah,###,###,56,50,6,4,2,0,22,27,1
Khulna,Kushtia,Kushtia Sadar,Jhaudia,1,1,0,0,0,0,0,1,0
Khulna,Kushtia,Kushtia Sadar,Jiarakhi,1,1,0,0,0,0,1,0,0
Khulna,Kushtia,Kushtia Sadar,Paitkabari,1,1,0,0,0,0,1,0,0
Khulna,Kushtia,Kushtia Sadar,Alampur,1,1,0,0,0,0,1,0,0
Khulna,Kushtia,Kushtia Sadar,Ujangram,1,1,0,0,0,0,1,0,0
Khulna,Kushtia,Kushtia Sadar,Kushtia Paurashava,2,1,1,1,0,0,1,0,0
Khulna,Kushtia,Kushtia Sadar,Manohardia,1,1,0,0,0,0,1,0,0
Khulna,Kushtia,Kushtia Sadar,Abdulpur,1,1,0,0,0,0,0,1,0
Khulna,Kushtia,Kushtia Sadar,Ailchara,0,0,0,0,0,0,0,0,0
Khulna,Kushtia,Kushtia Sadar,Barakhada,0,0,0,0,0,0,0,0,0
Khulna,Kushtia,Kushtia Sadar,Gosind Durgapur,0,0,0,0,0,0,0,0,0
Khulna,Kushtia,Kushtia Sadar,Harinarayanpur,0,0,0,0,0,0,0,0,0
Khulna,Kushtia,Kushtia Sadar,Hatas Haripur,0,0,0,0,0,0,0,0,0
Khulna,Kushtia,Kushtia Sadar,Jagati,0,0,0,0,0,0,0,0,0
Khulna,Kushtia,Kushtia Sadar,Mazampur,0,0,0,0,0,0,0,0,0
Khulna,Kushtia,Kushtia Sadar,###,9,8,1,1,0,0,6,2,0
Khulna,Kushtia,Daulatpur,Mathurapur,1,1,0,0,0,0,1,0,0
Khulna,Kushtia,Daulatpur,Daulatpur,1,1,0,0,0,0,1,0,0
Khulna,Kushtia,Daulatpur,Ramkrishnapur,1,1,0,0,0,0,1,0,0
Khulna,Kushtia,Daulatpur,Aria,1,1,0,0,0,0,1,0,0
Khulna,Kushtia,Daulatpur,Hogalbaria,2,1,1,1,0,0,1,0,0
Khulna,Kushtia,Daulatpur,Pearpur,1,1,0,0,0,0,1,0,0
Khulna,Kushtia,Daulatpur,Maricha,1,1,0,0,0,0,1,0,0
Khulna,Kushtia,Daulatpur,Adabaria,0,0,0,0,0,0,0,0,0
Khulna,Kushtia,Daulatpur,Boalia,0,0,0,0,0,0,0,0,0
Khulna,Kushtia,Daulatpur,Chilmari,0,0,0,0,0,0,0,0,0
Khulna,Kushtia,Daulatpur,Khalishakundi,0,0,0,0,0,0,0,0,0
Khulna,Kushtia,Daulatpur,Philipnagar,0,0,0,0,0,0,0,0,0
Khulna,Kushtia,Daulatpur,Prayagpur,0,0,0,0,0,0,0,0,0
Khulna,Kushtia,Daulatpur,Refayetpur,0,0,0,0,0,0,0,0,0
Khulna,Kushtia,Daulatpur,###,8,7,1,1,0,0,7,0,0
Khulna,Kushtia,Khoksa,Janipur,1,1,0,0,0,0,1,0,0
Khulna,Kushtia,Khoksa,Jayanti Hajra,2,2,0,0,0,0,2,0,0
Khulna,Kushtia,Khoksa,Khoksa Paurashava,2,1,1,1,0,0,1,0,0
Khulna,Kushtia,Khoksa,Osmanpur,1,1,0,0,0,0,1,0,0
Khulna,Kushtia,Khoksa,Ambaria,0,0,0,0,0,0,0,0,0
Khulna,Kushtia,Khoksa,Betbaria,0,0,0,0,0,0,0,0,0
Khulna,Kushtia,Khoksa,Gopagram,0,0,0,0,0,0,0,0,0
Khulna,Kushtia,Khoksa,Khoksa,0,0,0,0,0,0,0,0,0
Khulna,Kushtia,Khoksa,Samaspur,0,0,0,0,0,0,0,0,0
Khulna,Kushtia,Khoksa,Shimulia,0,0,0,0,0,0,0,0,0
Khulna,Kushtia,Khoksa,###,6,5,1,1,0,0,5,0,0
Khulna,Kushtia,Bheramara,Dharampur,2,2,0,0,0,0,2,0,0
Khulna,Kushtia,Bheramara,Bheramara Paurashava,1,1,0,0,0,0,1,0,0
Khulna,Kushtia,Bheramara,Mokarimpur,3,2,1,1,0,0,1,1,0
Khulna,Kushtia,Bheramara,Juniadaha,1,1,0,0,0,0,0,1,0
Khulna,Kushtia,Bheramara,Bahadurpur,0,0,0,0,0,0,0,0,0
Khulna,Kushtia,Bheramara,Bahir Char,0,0,0,0,0,0,0,0,0
Khulna,Kushtia,Bheramara,Chandgram,0,0,0,0,0,0,0,0,0
Khulna,Kushtia,Bheramara,###,7,6,1,1,0,0,4,2,0
Khulna,Kushtia,Mirpur,Ambaria,1,1,0,0,0,0,1,0,0
Khulna,Kushtia,Mirpur,Talbaria,1,1,0,0,0,0,1,0,0
Khulna,Kushtia,Mirpur,Poradaha,2,2,0,0,0,0,2,0,0
Khulna,Kushtia,Mirpur,Bahalbaria,1,1,0,0,0,0,0,1,0
Khulna,Kushtia,Mirpur,Chhatian,1,1,0,0,0,0,1,0,0
Khulna,Kushtia,Mirpur,Chithulia,1,1,0,0,0,0,0,1,0
Khulna,Kushtia,Mirpur,Malihad,1,1,0,0,0,0,0,1,0
Khulna,Kushtia,Mirpur,Amla,1,1,0,0,0,0,1,0,0
Khulna,Kushtia,Mirpur,Barui Para,0,0,0,0,0,0,0,0,0
Khulna,Kushtia,Mirpur,Fulbaria,0,0,0,0,0,0,0,0,0
Khulna,Kushtia,Mirpur,Kursha,0,0,0,0,0,0,0,0,0
Khulna,Kushtia,Mirpur,Mirpur Paurashava,0,0,0,0,0,0,0,0,0
Khulna,Kushtia,Mirpur,Sardarpur,0,0,0,0,0,0,0,0,0
Khulna,Kushtia,Mirpur,###,9,9,0,0,0,0,6,3,0
Khulna,Kushtia,Kumarkhali,Kaya,1,1,0,0,0,0,1,0,0
Khulna,Kushtia,Kumarkhali,Chandpur,1,1,0,0,0,0,1,0,0
Khulna,Kushtia,Kumarkhali,Chapra,1,1,0,0,0,0,1,0,0
Khulna,Kushtia,Kumarkhali,Jadu Boyra,1,1,0,0,0,0,1,0,0
Khulna,Kushtia,Kumarkhali,Kumarkhali Paurashava,2,1,1,1,0,0,1,0,0
Khulna,Kushtia,Kumarkhali,Shelaidaha,1,1,0,0,0,0,1,0,0
Khulna,Kushtia,Kumarkhali,Jagannathpur,1,1,0,0,0,0,1,0,0
Khulna,Kushtia,Kumarkhali,Bagulat,0,0,0,0,0,0,0,0,0
Khulna,Kushtia,Kumarkhali,Nandalalpur,0,0,0,0,0,0,0,0,0
Khulna,Kushtia,Kumarkhali,Panti,0,0,0,0,0,0,0,0,0
Khulna,Kushtia,Kumarkhali,Sadaki,0,0,0,0,0,0,0,0,0
Khulna,Kushtia,Kumarkhali,Sadipur,0,0,0,0,0,0,0,0,0
Khulna,Kushtia,Kumarkhali,###,8,7,1,1,0,0,7,0,0
Khulna,Kushtia,###,###,47,42,5,5,0,0,35,7,0
Khulna,Meherpur,Gangni,Roypur,1,1,0,0,0,0,1,0,0
Khulna,Meherpur,Gangni,Gangni Paurashava,2,1,1,1,0,0,1,0,0
Khulna,Meherpur,Gangni,Dhankhola,1,1,0,0,0,0,1,0,0
Khulna,Meherpur,Gangni,Matmura,1,1,0,0,0,0,1,0,0
Khulna,Meherpur,Gangni,Kathuli,1,1,0,0,0,0,1,0,0
Khulna,Meherpur,Gangni,Tentulbaria,1,1,0,0,0,0,1,0,0
Khulna,Meherpur,Gangni,Bamandi,0,0,0,0,0,0,0,0,0
Khulna,Meherpur,Gangni,Kazipur,0,0,0,0,0,0,0,0,0
Khulna,Meherpur,Gangni,Shaharbati,0,0,0,0,0,0,0,0,0
Khulna,Meherpur,Gangni,Shola Taka,0,0,0,0,0,0,0,0,0
Khulna,Meherpur,Gangni,###,7,6,1,1,0,0,6,0,0
Khulna,Meherpur,Meherpur Sadar,Buripota,1,1,0,0,0,0,1,0,0
Khulna,Meherpur,Meherpur Sadar,Kutubpur,1,1,0,0,0,0,1,0,0
Khulna,Meherpur,Meherpur Sadar,Amjhupi,1,1,0,0,0,0,1,0,0
Khulna,Meherpur,Meherpur Sadar,Amda,0,0,0,0,0,0,0,0,0
Khulna,Meherpur,Meherpur Sadar,Meherpur Paurashava,0,0,0,0,0,0,0,0,0
Khulna,Meherpur,Meherpur Sadar,Pirojpur,0,0,0,0,0,0,0,0,0
Khulna,Meherpur,Meherpur Sadar,###,3,3,0,0,0,0,3,0,0
Khulna,Meherpur,Mujib Nagar,Monakhali,1,1,0,0,0,0,1,0,0
Khulna,Meherpur,Mujib Nagar,Bagoan,4,2,2,2,0,0,2,0,0
Khulna,Meherpur,Mujib Nagar,Mahajanpur,1,1,0,0,0,0,1,0,0
Khulna,Meherpur,Mujib Nagar,Dariapur,0,0,0,0,0,0,0,0,0
Khulna,Meherpur,Mujib Nagar,###,6,4,2,2,0,0,4,0,0
Khulna,Meherpur,###,###,16,13,3,3,0,0,13,0,0
Khulna,Chuadanga,Chuadanga Sadar,Kutubpur,1,1,0,0,0,0,1,0,0
Khulna,Chuadanga,Chuadanga Sadar,Alokdia,1,1,0,0,0,0,1,0,0
Khulna,Chuadanga,Chuadanga Sadar,Begampur,1,1,0,0,0,0,1,0,0
Khulna,Chuadanga,Chuadanga Sadar,Titudaha,2,2,0,0,0,2,0,0,0
Khulna,Chuadanga,Chuadanga Sadar,Mominpur,1,1,0,0,0,0,1,0,0
Khulna,Chuadanga,Chuadanga Sadar,Chuadanga Paurashava,2,1,1,1,0,0,1,0,0
Khulna,Chuadanga,Chuadanga Sadar,Padmabila,1,1,0,0,0,0,1,0,0
Khulna,Chuadanga,Chuadanga Sadar,Shankar Chandra,1,1,0,0,0,1,0,0,0
Khulna,Chuadanga,Chuadanga Sadar,###,10,9,1,1,0,3,6,0,0
Khulna,Chuadanga,Jiban Nagar,Andulbaria,1,1,0,0,0,0,1,0,0
Khulna,Chuadanga,Jiban Nagar,Simanta,1,1,0,0,0,0,1,0,0
Khulna,Chuadanga,Jiban Nagar,Jiban Nagar Paurashava,2,1,1,1,0,0,1,0,0
Khulna,Chuadanga,Jiban Nagar,Uthali,1,1,0,0,0,0,1,0,0
Khulna,Chuadanga,Jiban Nagar,Banka,0,0,0,0,0,0,0,0,0
Khulna,Chuadanga,Jiban Nagar,###,5,4,1,1,0,0,4,0,0
Khulna,Chuadanga,Alamdanga,Jamjami,1,1,0,0,0,0,1,0,0
Khulna,Chuadanga,Alamdanga,Hardi,2,2,0,0,0,0,1,1,0
Khulna,Chuadanga,Alamdanga,Gangni,1,1,0,0,0,0,1,0,0
Khulna,Chuadanga,Alamdanga,Alamdanga Paurashava,2,2,0,0,0,0,1,0,1
Khulna,Chuadanga,Alamdanga,Nagdaha,1,1,0,0,0,0,1,0,0
Khulna,Chuadanga,Alamdanga,Baradi,1,1,0,0,0,0,1,0,0
Khulna,Chuadanga,Alamdanga,Jehala,1,1,0,0,0,0,1,0,0
Khulna,Chuadanga,Alamdanga,Chithla,1,1,0,0,0,0,1,0,0
Khulna,Chuadanga,Alamdanga,Belgachhi,0,0,0,0,0,0,0,0,0
Khulna,Chuadanga,Alamdanga,Bhangabaria,0,0,0,0,0,0,0,0,0
Khulna,Chuadanga,Alamdanga,Dauki,0,0,0,0,0,0,0,0,0
Khulna,Chuadanga,Alamdanga,Kalidashpur,0,0,0,0,0,0,0,0,0
Khulna,Chuadanga,Alamdanga,Khadimpur,0,0,0,0,0,0,0,0,0
Khulna,Chuadanga,Alamdanga,Khaskara,0,0,0,0,0,0,0,0,0
Khulna,Chuadanga,Alamdanga,Kumari,0,0,0,0,0,0,0,0,0
Khulna,Chuadanga,Alamdanga,###,10,10,0,0,0,0,8,1,1
Khulna,Chuadanga,Damurhuda,Natipota,1,1,0,0,0,0,1,0,0
Khulna,Chuadanga,Damurhuda,Damurhuda,2,2,0,0,0,0,2,0,0
Khulna,Chuadanga,Damurhuda,Howli,1,0,1,1,0,0,0,0,0
Khulna,Chuadanga,Damurhuda,Perkrishnapur Madna,1,1,0,0,0,0,0,1,0
Khulna,Chuadanga,Damurhuda,Kapasadanga,1,1,0,0,0,0,1,0,0
Khulna,Chuadanga,Damurhuda,Kuralgachhi,1,1,0,0,0,0,1,0,0
Khulna,Chuadanga,Damurhuda,Juranpur,1,1,0,0,0,0,0,1,0
Khulna,Chuadanga,Damurhuda,Darshana Paurashava,0,0,0,0,0,0,0,0,0
Khulna,Chuadanga,Damurhuda,###,8,7,1,1,0,0,5,2,0
Khulna,Chuadanga,###,###,33,30,3,3,0,3,23,3,1
Khulna,###,###,###,1290,404,886,31,855,25,215,148,16
Dhaka,Dhaka,Uttara,Ward No-01,2,0,2,0,2,0,0,0,0
Dhaka,Dhaka,Uttara,###,2,0,2,0,2,0,0,0,0
Dhaka,Dhaka,Adabor,Ward No-43,1,0,1,0,1,0,0,0,0
Dhaka,Dhaka,Adabor,Ward No-46,0,0,0,0,0,0,0,0,0
Dhaka,Dhaka,Adabor,###,1,0,1,0,1,0,0,0,0
Dhaka,Dhaka,Mohammadpur,Ward No-47 (part),1,0,1,0,1,0,0,0,0
Dhaka,Dhaka,Mohammadpur,Ward No-44,2,0,2,0,2,0,0,0,0
Dhaka,Dhaka,Mohammadpur,Ward No-42,0,0,0,0,0,0,0,0,0
Dhaka,Dhaka,Mohammadpur,Ward No-45,0,0,0,0,0,0,0,0,0
Dhaka,Dhaka,Mohammadpur,Ward No-46,0,0,0,0,0,0,0,0,0
Dhaka,Dhaka,Mohammadpur,Ward No-51 (part),0,0,0,0,0,0,0,0,0
Dhaka,Dhaka,Mohammadpur,###,3,0,3,0,3,0,0,0,0
Dhaka,Dhaka,Shahbagh,Ward No-56 (part),3,0,3,0,3,0,0,0,0
Dhaka,Dhaka,Shahbagh,Ward No-57,0,0,0,0,0,0,0,0,0
Dhaka,Dhaka,Shahbagh,###,3,0,3,0,3,0,0,0,0
Dhaka,Dhaka,Hazaribagh,Ward No-48 (Part),1,0,1,0,1,0,0,0,0
Dhaka,Dhaka,Hazaribagh,Ward No-58,1,0,1,0,1,0,0,0,0
Dhaka,Dhaka,Hazaribagh,Ward No-46 (Part),0,0,0,0,0,0,0,0,0
Dhaka,Dhaka,Hazaribagh,###,2,0,2,0,2,0,0,0,0
Dhaka,Dhaka,Chak Bazar,Ward No-65,1,0,1,0,1,0,0,0,0
Dhaka,Dhaka,Chak Bazar,Ward No-63 (Part),0,0,0,0,0,0,0,0,0
Dhaka,Dhaka,Chak Bazar,Ward No-64,0,0,0,0,0,0,0,0,0
Dhaka,Dhaka,Chak Bazar,Ward No-66 (Part),0,0,0,0,0,0,0,0,0
Dhaka,Dhaka,Chak Bazar,Ward No-67 (Part),0,0,0,0,0,0,0,0,0
Dhaka,Dhaka,Chak Bazar,###,1,0,1,0,1,0,0,0,0
Dhaka,Dhaka,Kotwali,Ward No-73,1,0,1,0,1,0,0,0,0
Dhaka,Dhaka,Kotwali,Ward No-68 (Part),0,0,0,0,0,0,0,0,0
Dhaka,Dhaka,Kotwali,Ward No-71 (Part),0,0,0,0,0,0,0,0,0
Dhaka,Dhaka,Kotwali,Ward No-72,0,0,0,0,0,0,0,0,0
Dhaka,Dhaka,Kotwali,###,1,0,1,0,1,0,0,0,0
Dhaka,Dhaka,Motijheel,Ward No-33,1,0,1,0,1,0,0,0,0
Dhaka,Dhaka,Motijheel,Ward No-31,0,0,0,0,0,0,0,0,0
Dhaka,Dhaka,Motijheel,Ward No-32,0,0,0,0,0,0,0,0,0
Dhaka,Dhaka,Motijheel,Ward No-34,0,0,0,0,0,0,0,0,0
Dhaka,Dhaka,Motijheel,Ward No-35,0,0,0,0,0,0,0,0,0
Dhaka,Dhaka,Motijheel,###,1,0,1,0,1,0,0,0,0
Dhaka,Dhaka,Sutrapur,Ward No-79,1,0,1,0,1,0,0,0,0
Dhaka,Dhaka,Sutrapur,Ward No-74,0,0,0,0,0,0,0,0,0
Dhaka,Dhaka,Sutrapur,Ward No-75,0,0,0,0,0,0,0,0,0
Dhaka,Dhaka,Sutrapur,Ward No-77,0,0,0,0,0,0,0,0,0
Dhaka,Dhaka,Sutrapur,Ward No-78,0,0,0,0,0,0,0,0,0
Dhaka,Dhaka,Sutrapur,Ward No-80 (Part),0,0,0,0,0,0,0,0,0
Dhaka,Dhaka,Sutrapur,###,1,0,1,0,1,0,0,0,0
Dhaka,Dhaka,Kadamtali,Shyampur,1,0,1,0,1,0,0,0,0
Dhaka,Dhaka,Kadamtali,Dhania (part),0,0,0,0,0,0,0,0,0
Dhaka,Dhaka,Kadamtali,Matuail (part),0,0,0,0,0,0,0,0,0
Dhaka,Dhaka,Kadamtali,Ward No-88,0,0,0,0,0,0,0,0,0
Dhaka,Dhaka,Kadamtali,Ward No-89,0,0,0,0,0,0,0,0,0
Dhaka,Dhaka,Kadamtali,###,1,0,1,0,1,0,0,0,0
Dhaka,Dhaka,Ramna,Ward No-53,3,0,3,0,3,0,0,0,0
Dhaka,Dhaka,Ramna,Ward No-55,1,0,1,0,1,0,0,0,0
Dhaka,Dhaka,Ramna,Ward No-54,0,0,0,0,0,0,0,0,0
Dhaka,Dhaka,Ramna,###,4,0,4,0,4,0,0,0,0
Dhaka,Dhaka,Tejgaon Ind. Area,Ward No-37,1,0,1,0,1,0,0,0,0
Dhaka,Dhaka,Tejgaon Ind. Area,Ward No-20 (Part),0,0,0,0,0,0,0,0,0
Dhaka,Dhaka,Tejgaon Ind. Area,Ward No-38 (Part),0,0,0,0,0,0,0,0,0
Dhaka,Dhaka,Tejgaon Ind. Area,###,1,0,1,0,1,0,0,0,0
Dhaka,Dhaka,Gulshan,Ward No-19,3,0,3,0,3,0,0,0,0
Dhaka,Dhaka,Gulshan,Ward No-18,1,0,1,0,1,0,0,0,0
Dhaka,Dhaka,Gulshan,Ward No-20 (Part),0,0,0,0,0,0,0,0,0
Dhaka,Dhaka,Gulshan,###,4,0,4,0,4,0,0,0,0
Dhaka,Dhaka,Khilkhet,Ward No-17 (Part),1,0,1,0,1,0,0,0,0
Dhaka,Dhaka,Khilkhet,Dakshinkhan (part),0,0,0,0,0,0,0,0,0
Dhaka,Dhaka,Khilkhet,Dumni,0,0,0,0,0,0,0,0,0
Dhaka,Dhaka,Khilkhet,###,1,0,1,0,1,0,0,0,0
Dhaka,Dhaka,Kafrul,Ward No-04,1,0,1,0,1,0,0,0,0
Dhaka,Dhaka,Kafrul,Ward No-14 (part),0,0,0,0,0,0,0,0,0
Dhaka,Dhaka,Kafrul,Ward No-15 (part),0,0,0,0,0,0,0,0,0
Dhaka,Dhaka,Kafrul,Ward No-16,0,0,0,0,0,0,0,0,0
Dhaka,Dhaka,Kafrul,###,1,0,1,0,1,0,0,0,0
Dhaka,Dhaka,Pallabi,Ward No-05,1,0,1,0,1,0,0,0,0
Dhaka,Dhaka,Pallabi,Ward No-02,0,0,0,0,0,0,0,0,0
Dhaka,Dhaka,Pallabi,Ward No-03,0,0,0,0,0,0,0,0,0
Dhaka,Dhaka,Pallabi,Ward No-06,0,0,0,0,0,0,0,0,0
Dhaka,Dhaka,Pallabi,Ward No-15 (part),0,0,0,0,0,0,0,0,0
Dhaka,Dhaka,Pallabi,###,1,0,1,0,1,0,0,0,0
Dhaka,Dhaka,Turag,Harirampur (Part),1,0,1,0,1,0,0,0,0
Dhaka,Dhaka,Turag,###,1,0,1,0,1,0,0,0,0
Dhaka,Dhaka,Dhanmondi,Ward No-49,1,0,1,0,1,0,0,0,0
Dhaka,Dhaka,Dhanmondi,Ward No-47 (Part),0,0,0,0,0,0,0,0,0
Dhaka,Dhaka,Dhanmondi,Ward No-48 (Part),0,0,0,0,0,0,0,0,0
Dhaka,Dhaka,Dhanmondi,###,1,0,1,0,1,0,0,0,0
Dhaka,Dhaka,Sher-e-bangla Nagar,Ward No-40 (Part),1,0,1,0,1,0,0,0,0
Dhaka,Dhaka,Sher-e-bangla Nagar,Ward No-41,1,0,1,0,1,0,0,0,0
Dhaka,Dhaka,Sher-e-bangla Nagar,###,2,0,2,0,2,0,0,0,0
Dhaka,Dhaka,Mirpur,Ward No-12,1,0,1,0,1,0,0,0,0
Dhaka,Dhaka,Mirpur,Ward No-13,2,0,2,0,2,0,0,0,0
Dhaka,Dhaka,Mirpur,Ward No-07 (Part),0,0,0,0,0,0,0,0,0
Dhaka,Dhaka,Mirpur,Ward No-11,0,0,0,0,0,0,0,0,0
Dhaka,Dhaka,Mirpur,Ward No-14 (part),0,0,0,0,0,0,0,0,0
Dhaka,Dhaka,Mirpur,###,3,0,3,0,3,0,0,0,0
Dhaka,Dhaka,Biman Bandar,Dakshinkhan (part),1,0,1,0,1,0,0,0,0
Dhaka,Dhaka,Biman Bandar,Ward No-01,0,0,0,0,0,0,0,0,0
Dhaka,Dhaka,Biman Bandar,Ward No-98 (rest. Area),0,0,0,0,0,0,0,0,0
Dhaka,Dhaka,Biman Bandar,###,1,0,1,0,1,0,0,0,0
Dhaka,Dhaka,Badda,Ward No-17 (Part),1,0,1,0,1,0,0,0,0
Dhaka,Dhaka,Badda,Satarkul,1,0,1,0,1,0,0,0,0
Dhaka,Dhaka,Badda,Ward No-21,1,0,1,0,1,0,0,0,0
Dhaka,Dhaka,Badda,Bhatara,1,0,1,0,1,0,0,0,0
Dhaka,Dhaka,Badda,Badda,0,0,0,0,0,0,0,0,0
Dhaka,Dhaka,Badda,Beraid,0,0,0,0,0,0,0,0,0
Dhaka,Dhaka,Badda,###,4,0,4,0,4,0,0,0,0
Dhaka,Dhaka,Jatrabari,Ward No-85,1,0,1,0,1,0,0,0,0
Dhaka,Dhaka,Jatrabari,Matuail (part),1,0,1,0,1,0,0,0,0
Dhaka,Dhaka,Jatrabari,Ward No-84,2,0,2,0,2,0,0,0,0
Dhaka,Dhaka,Jatrabari,Dhania (part),0,0,0,0,0,0,0,0,0
Dhaka,Dhaka,Jatrabari,Ward No-76 (Part),0,0,0,0,0,0,0,0,0
Dhaka,Dhaka,Jatrabari,Ward No-86,0,0,0,0,0,0,0,0,0
Dhaka,Dhaka,Jatrabari,###,4,0,4,0,4,0,0,0,0
Dhaka,Dhaka,Sabujbagh,Ward No-28,1,0,1,0,1,0,0,0,0
Dhaka,Dhaka,Sabujbagh,Dakshingaon (Part),0,0,0,0,0,0,0,0,0
Dhaka,Dhaka,Sabujbagh,Manda,0,0,0,0,0,0,0,0,0
Dhaka,Dhaka,Sabujbagh,Ward No-27,0,0,0,0,0,0,0,0,0
Dhaka,Dhaka,Sabujbagh,Ward No-29,0,0,0,0,0,0,0,0,0
Dhaka,Dhaka,Sabujbagh,Ward No-30,0,0,0,0,0,0,0,0,0
Dhaka,Dhaka,Sabujbagh,###,1,0,1,0,1,0,0,0,0
Dhaka,Dhaka,Dohar,Kushumhati,3,1,2,0,2,0,0,1,0
Dhaka,Dhaka,Dohar,Nayabari,1,1,0,0,0,0,0,0,1
Dhaka,Dhaka,Dohar,Narisha,1,1,0,0,0,0,0,1,0
Dhaka,Dhaka,Dohar,Muksudpur,1,1,0,0,0,0,0,1,0
Dhaka,Dhaka,Dohar,Sutar Para,1,1,0,0,0,0,0,1,0
Dhaka,Dhaka,Dohar,Dohar Paurashava,1,1,0,0,0,0,0,1,0
Dhaka,Dhaka,Dohar,Bilaspur,4,0,4,0,4,0,0,0,0
Dhaka,Dhaka,Dohar,Mahmudpur,0,0,0,0,0,0,0,0,0
Dhaka,Dhaka,Dohar,Roypara,0,0,0,0,0,0,0,0,0
Dhaka,Dhaka,Dohar,###,12,6,6,0,6,0,0,5,1
Dhaka,Dhaka,Nawabganj,Kalakopa,2,0,2,0,2,0,0,0,0
Dhaka,Dhaka,Nawabganj,Agla,3,2,1,0,1,0,0,2,0
Dhaka,Dhaka,Nawabganj,Churain,6,1,5,1,4,0,0,1,0
Dhaka,Dhaka,Nawabganj,Jantrail,8,1,7,0,7,0,0,1,0
Dhaka,Dhaka,Nawabganj,Bakshanagar,7,1,6,0,6,0,0,1,0
Dhaka,Dhaka,Nawabganj,Bandura,2,1,1,0,1,0,1,0,0
Dhaka,Dhaka,Nawabganj,Barrah,3,1,2,0,2,0,0,1,0
Dhaka,Dhaka,Nawabganj,Sholla,4,0,4,0,4,0,0,0,0
Dhaka,Dhaka,Nawabganj,Baruakhali,0,0,0,0,0,0,0,0,0
Dhaka,Dhaka,Nawabganj,Galimpur,0,0,0,0,0,0,0,0,0
Dhaka,Dhaka,Nawabganj,Joykrishnapur,0,0,0,0,0,0,0,0,0
Dhaka,Dhaka,Nawabganj,Kailail,0,0,0,0,0,0,0,0,0
Dhaka,Dhaka,Nawabganj,Nayansree,0,0,0,0,0,0,0,0,0
Dhaka,Dhaka,Nawabganj,Shikari Para,0,0,0,0,0,0,0,0,0
Dhaka,Dhaka,Nawabganj,###,35,7,28,1,27,0,1,6,0
Dhaka,Dhaka,Lalbagh,Ward No-62,2,0,2,0,2,0,0,0,0
Dhaka,Dhaka,Lalbagh,Ward No-56 (Part),0,0,0,0,0,0,0,0,0
Dhaka,Dhaka,Lalbagh,Ward No-59,0,0,0,0,0,0,0,0,0
Dhaka,Dhaka,Lalbagh,Ward No-60,0,0,0,0,0,0,0,0,0
Dhaka,Dhaka,Lalbagh,Ward No-61,0,0,0,0,0,0,0,0,0
Dhaka,Dhaka,Lalbagh,Ward No-91,0,0,0,0,0,0,0,0,0
Dhaka,Dhaka,Lalbagh,Ward No-92,0,0,0,0,0,0,0,0,0
Dhaka,Dhaka,Lalbagh,###,2,0,2,0,2,0,0,0,0
Dhaka,Dhaka,Kalabagan,Ward No-50,2,0,2,0,2,0,0,0,0
Dhaka,Dhaka,Kalabagan,Ward No-51 (Part),0,0,0,0,0,0,0,0,0
Dhaka,Dhaka,Kalabagan,###,2,0,2,0,2,0,0,0,0
Dhaka,Dhaka,Savar,Savar,1,0,1,1,0,0,0,0,0
Dhaka,Dhaka,Savar,Ashulia,1,1,0,0,0,0,0,1,0
Dhaka,Dhaka,Savar,Shimulia,1,1,0,0,0,0,0,1,0
Dhaka,Dhaka,Savar,Pathalia (part),1,1,0,0,0,0,1,0,0
Dhaka,Dhaka,Savar,Tetuljhora,1,1,0,0,0,0,1,0,0
Dhaka,Dhaka,Savar,Banagram,1,1,0,0,0,0,1,0,0
Dhaka,Dhaka,Savar,Yearpur,1,1,0,0,0,0,1,0,0
Dhaka,Dhaka,Savar,Savar Paurashava,2,1,1,1,0,0,1,0,0
Dhaka,Dhaka,Savar,Amin Bazar,0,0,0,0,0,0,0,0,0
Dhaka,Dhaka,Savar,Bhakurta,0,0,0,0,0,0,0,0,0
Dhaka,Dhaka,Savar,Biralia,0,0,0,0,0,0,0,0,0
Dhaka,Dhaka,Savar,Dhamsana,0,0,0,0,0,0,0,0,0
Dhaka,Dhaka,Savar,Kaundia,0,0,0,0,0,0,0,0,0
Dhaka,Dhaka,Savar,###,9,7,2,2,0,0,5,2,0
Dhaka,Dhaka,Keraniganj,Ruhitpur,2,2,0,0,0,0,0,0,2
Dhaka,Dhaka,Keraniganj,Taranagar,1,1,0,0,0,0,0,0,1
Dhaka,Dhaka,Keraniganj,Konda,1,1,0,0,0,0,0,0,1
Dhaka,Dhaka,Keraniganj,Zinjira,1,1,0,0,0,0,0,0,1
Dhaka,Dhaka,Keraniganj,Basta,1,1,0,0,0,0,1,0,0
Dhaka,Dhaka,Keraniganj,Sakta,1,1,0,0,0,0,1,0,0
Dhaka,Dhaka,Keraniganj,Kalatia,1,1,0,0,0,0,1,0,0
Dhaka,Dhaka,Keraniganj,Aganagar,0,0,0,0,0,0,0,0,0
Dhaka,Dhaka,Keraniganj,Hazratpur,0,0,0,0,0,0,0,0,0
Dhaka,Dhaka,Keraniganj,Kalindi,0,0,0,0,0,0,0,0,0
Dhaka,Dhaka,Keraniganj,Subhadya (Part),0,0,0,0,0,0,0,0,0
Dhaka,Dhaka,Keraniganj,Tegharia,0,0,0,0,0,0,0,0,0
Dhaka,Dhaka,Keraniganj,###,8,8,0,0,0,0,3,0,5
Dhaka,Dhaka,Dhamrai,Kulla,1,1,0,0,0,0,1,0,0
Dhaka,Dhaka,Dhamrai,Sombhag,1,1,0,0,0,0,0,0,1
Dhaka,Dhaka,Dhamrai,Suti Para,1,1,0,0,0,0,0,1,0
Dhaka,Dhaka,Dhamrai,Kushura,1,1,0,0,0,0,0,1,0
Dhaka,Dhaka,Dhamrai,Dhamrai Paurashava,1,1,0,0,0,0,0,0,1
Dhaka,Dhaka,Dhamrai,Amta,1,1,0,0,0,0,1,0,0
Dhaka,Dhaka,Dhamrai,Balia,1,1,0,0,0,0,0,1,0
Dhaka,Dhaka,Dhamrai,Sanora,1,1,0,0,0,0,0,1,0
Dhaka,Dhaka,Dhamrai,Nannar,1,1,0,0,0,0,1,0,0
Dhaka,Dhaka,Dhamrai,Baisakanda,0,0,0,0,0,0,0,0,0
Dhaka,Dhaka,Dhamrai,Bhararia,0,0,0,0,0,0,0,0,0
Dhaka,Dhaka,Dhamrai,Chauhat,0,0,0,0,0,0,0,0,0
Dhaka,Dhaka,Dhamrai,Dhamrai,0,0,0,0,0,0,0,0,0
Dhaka,Dhaka,Dhamrai,Gangutia,0,0,0,0,0,0,0,0,0
Dhaka,Dhaka,Dhamrai,Jadabpur,0,0,0,0,0,0,0,0,0
Dhaka,Dhaka,Dhamrai,Rowail,0,0,0,0,0,0,0,0,0
Dhaka,Dhaka,Dhamrai,Suapur,0,0,0,0,0,0,0,0,0
Dhaka,Dhaka,Dhamrai,###,9,9,0,0,0,0,3,4,2
Dhaka,Dhaka,Khilgaon,Dakshingaon (Part),0,0,0,0,0,0,0,0,0
Dhaka,Dhaka,Khilgaon,Nasirabad,0,0,0,0,0,0,0,0,0
Dhaka,Dhaka,Khilgaon,Ward No-24,0,0,0,0,0,0,0,0,0
Dhaka,Dhaka,Khilgaon,Ward No-25,0,0,0,0,0,0,0,0,0
Dhaka,Dhaka,Khilgaon,Ward No-26,0,0,0,0,0,0,0,0,0
Dhaka,Dhaka,Khilgaon,###,0,0,0,0,0,0,0,0,0
Dhaka,Dhaka,Dakshinkhan,Dakshinkhan (Part),0,0,0,0,0,0,0,0,0
Dhaka,Dhaka,Dakshinkhan,###,0,0,0,0,0,0,0,0,0
Dhaka,Dhaka,Demra,Demra (part),0,0,0,0,0,0,0,0,0
Dhaka,Dhaka,Demra,Matuail (part),0,0,0,0,0,0,0,0,0
Dhaka,Dhaka,Demra,Saralia,0,0,0,0,0,0,0,0,0
Dhaka,Dhaka,Demra,###,0,0,0,0,0,0,0,0,0
Dhaka,Dhaka,Kamrangir Char,Sultanganj,0,0,0,0,0,0,0,0,0
Dhaka,Dhaka,Kamrangir Char,###,0,0,0,0,0,0,0,0,0
Dhaka,Dhaka,Uttar Khan,Uttar Khan,0,0,0,0,0,0,0,0,0
Dhaka,Dhaka,Uttar Khan,###,0,0,0,0,0,0,0,0,0
Dhaka,Dhaka,Shah Ali,Ward No-08,0,0,0,0,0,0,0,0,0
Dhaka,Dhaka,Shah Ali,###,0,0,0,0,0,0,0,0,0
Dhaka,Dhaka,Darus Salam,Ward No-09,0,0,0,0,0,0,0,0,0
Dhaka,Dhaka,Darus Salam,Ward No-10,0,0,0,0,0,0,0,0,0
Dhaka,Dhaka,Darus Salam,###,0,0,0,0,0,0,0,0,0
Dhaka,Dhaka,Cantonment,Ward No-15 (part),0,0,0,0,0,0,0,0,0
Dhaka,Dhaka,Cantonment,Ward No-98 (Rest. Area),0,0,0,0,0,0,0,0,0
Dhaka,Dhaka,Cantonment,###,0,0,0,0,0,0,0,0,0
Dhaka,Dhaka,Rampura,Ward No-22,0,0,0,0,0,0,0,0,0
Dhaka,Dhaka,Rampura,Ward No-23,0,0,0,0,0,0,0,0,0
Dhaka,Dhaka,Rampura,###,0,0,0,0,0,0,0,0,0
Dhaka,Dhaka,Paltan,Ward No-36,0,0,0,0,0,0,0,0,0
Dhaka,Dhaka,Paltan,###,0,0,0,0,0,0,0,0,0
Dhaka,Dhaka,Tejgaon,Ward No-38 (Part),0,0,0,0,0,0,0,0,0
Dhaka,Dhaka,Tejgaon,Ward No-39,0,0,0,0,0,0,0,0,0
Dhaka,Dhaka,Tejgaon,Ward No-40 (Part),0,0,0,0,0,0,0,0,0
Dhaka,Dhaka,Tejgaon,###,0,0,0,0,0,0,0,0,0
Dhaka,Dhaka,New Market,Ward No-52,0,0,0,0,0,0,0,0,0
Dhaka,Dhaka,New Market,###,0,0,0,0,0,0,0,0,0
Dhaka,Dhaka,Bangshal,Ward No-63 (Part),0,0,0,0,0,0,0,0,0
Dhaka,Dhaka,Bangshal,Ward No-66 (Part),0,0,0,0,0,0,0,0,0
Dhaka,Dhaka,Bangshal,Ward No-67 (part),0,0,0,0,0,0,0,0,0
Dhaka,Dhaka,Bangshal,Ward No-68 (part),0,0,0,0,0,0,0,0,0
Dhaka,Dhaka,Bangshal,Ward No-69,0,0,0,0,0,0,0,0,0
Dhaka,Dhaka,Bangshal,Ward No-70,0,0,0,0,0,0,0,0,0
Dhaka,Dhaka,Bangshal,Ward No-71 (Part),0,0,0,0,0,0,0,0,0
Dhaka,Dhaka,Bangshal,###,0,0,0,0,0,0,0,0,0
Dhaka,Dhaka,Gendaria,Ward No-76 (Part),0,0,0,0,0,0,0,0,0
Dhaka,Dhaka,Gendaria,Ward No-80 (Part),0,0,0,0,0,0,0,0,0
Dhaka,Dhaka,Gendaria,Ward No-81,0,0,0,0,0,0,0,0,0
Dhaka,Dhaka,Gendaria,Ward No-82,0,0,0,0,0,0,0,0,0
Dhaka,Dhaka,Gendaria,###,0,0,0,0,0,0,0,0,0
Dhaka,Dhaka,Shyampur,Ward No-83,0,0,0,0,0,0,0,0,0
Dhaka,Dhaka,Shyampur,Ward No-87,0,0,0,0,0,0,0,0,0
Dhaka,Dhaka,Shyampur,Ward No-90,0,0,0,0,0,0,0,0,0
Dhaka,Dhaka,Shyampur,###,0,0,0,0,0,0,0,0,0
Dhaka,Dhaka,###,###,122,37,85,3,82,0,12,17,8
Dhaka,Gopalganj,Gopalganj Sadar,Ulpur,3,1,2,0,2,0,1,0,0
Dhaka,Gopalganj,Gopalganj Sadar,Satpar,2,1,1,0,1,0,1,0,0
Dhaka,Gopalganj,Gopalganj Sadar,Durgapur,1,1,0,0,0,0,1,0,0
Dhaka,Gopalganj,Gopalganj Sadar,Paikkandi,1,1,0,0,0,0,1,0,0
Dhaka,Gopalganj,Gopalganj Sadar,Kati,1,1,0,0,0,0,0,0,1
Dhaka,Gopalganj,Gopalganj Sadar,Gopalganj Paurashava,1,1,0,0,0,0,1,0,0
Dhaka,Gopalganj,Gopalganj Sadar,Haridaspur,1,1,0,0,0,0,1,0,0
Dhaka,Gopalganj,Gopalganj Sadar,Baultali,1,1,0,0,0,0,1,0,0
Dhaka,Gopalganj,Gopalganj Sadar,Suktail,1,1,0,0,0,0,1,0,0
Dhaka,Gopalganj,Gopalganj Sadar,Gobra,1,1,0,0,0,0,1,0,0
Dhaka,Gopalganj,Gopalganj Sadar,Borasi,0,0,0,0,0,0,0,0,0
Dhaka,Gopalganj,Gopalganj Sadar,Chandra Dighalia,0,0,0,0,0,0,0,0,0
Dhaka,Gopalganj,Gopalganj Sadar,Gopinathpur,0,0,0,0,0,0,0,0,0
Dhaka,Gopalganj,Gopalganj Sadar,Jalalabad,0,0,0,0,0,0,0,0,0
Dhaka,Gopalganj,Gopalganj Sadar,Kajulia,0,0,0,0,0,0,0,0,0
Dhaka,Gopalganj,Gopalganj Sadar,Karpara,0,0,0,0,0,0,0,0,0
Dhaka,Gopalganj,Gopalganj Sadar,Latifpur,0,0,0,0,0,0,0,0,0
Dhaka,Gopalganj,Gopalganj Sadar,Majhigati,0,0,0,0,0,0,0,0,0
Dhaka,Gopalganj,Gopalganj Sadar,Nizra,0,0,0,0,0,0,0,0,0
Dhaka,Gopalganj,Gopalganj Sadar,Raghunathpur,0,0,0,0,0,0,0,0,0
Dhaka,Gopalganj,Gopalganj Sadar,Sahapur,0,0,0,0,0,0,0,0,0
Dhaka,Gopalganj,Gopalganj Sadar,Urafi,0,0,0,0,0,0,0,0,0
Dhaka,Gopalganj,Gopalganj Sadar,###,13,10,3,0,3,0,9,0,1
Dhaka,Gopalganj,Muksudpur,Dignagar,1,0,1,0,1,0,0,0,0
Dhaka,Gopalganj,Muksudpur,Muksudpur Paurashava,4,2,2,0,2,0,0,1,1
Dhaka,Gopalganj,Muksudpur,Mochna,1,1,0,0,0,0,0,1,0
Dhaka,Gopalganj,Muksudpur,Ujani,1,1,0,0,0,0,0,0,1
Dhaka,Gopalganj,Muksudpur,Raghdi,1,1,0,0,0,0,1,0,0
Dhaka,Gopalganj,Muksudpur,Batikamari,1,1,0,0,0,0,1,0,0
Dhaka,Gopalganj,Muksudpur,Maharajpur,1,0,1,0,1,0,0,0,0
Dhaka,Gopalganj,Muksudpur,Bahugram,0,0,0,0,0,0,0,0,0
Dhaka,Gopalganj,Muksudpur,Banshbaria,0,0,0,0,0,0,0,0,0
Dhaka,Gopalganj,Muksudpur,Bhabrasur,0,0,0,0,0,0,0,0,0
Dhaka,Gopalganj,Muksudpur,Gobindapur,0,0,0,0,0,0,0,0,0
Dhaka,Gopalganj,Muksudpur,Gohala,0,0,0,0,0,0,0,0,0
Dhaka,Gopalganj,Muksudpur,Jalirpar,0,0,0,0,0,0,0,0,0
Dhaka,Gopalganj,Muksudpur,Kasalia,0,0,0,0,0,0,0,0,0
Dhaka,Gopalganj,Muksudpur,Khandarpar,0,0,0,0,0,0,0,0,0
Dhaka,Gopalganj,Muksudpur,Nanikshir,0,0,0,0,0,0,0,0,0
Dhaka,Gopalganj,Muksudpur,Pasargati,0,0,0,0,0,0,0,0,0
Dhaka,Gopalganj,Muksudpur,###,10,6,4,0,4,0,2,2,2
Dhaka,Gopalganj,Kotali Para,Amtali,19,1,18,0,18,0,1,0,0
Dhaka,Gopalganj,Kotali Para,Kandi,43,1,42,0,42,0,1,0,0
Dhaka,Gopalganj,Kotali Para,Suagram,21,0,21,0,21,0,0,0,0
Dhaka,Gopalganj,Kotali Para,Ghagar,21,1,20,0,20,0,1,0,0
Dhaka,Gopalganj,Kotali Para,Kalabari,21,1,20,0,20,0,0,0,1
Dhaka,Gopalganj,Kotali Para,Hiran,27,1,26,0,26,0,1,0,0
Dhaka,Gopalganj,Kotali Para,Radhaganj,62,1,61,0,61,0,1,0,0
Dhaka,Gopalganj,Kotali Para,Ramshil,18,0,18,0,18,0,0,0,0
Dhaka,Gopalganj,Kotali Para,Sadullapur,40,0,40,0,40,0,0,0,0
Dhaka,Gopalganj,Kotali Para,Bandhabari,18,0,18,0,18,0,0,0,0
Dhaka,Gopalganj,Kotali Para,Kotalipara Paurashava,5,0,5,0,5,0,0,0,0
Dhaka,Gopalganj,Kotali Para,Kushla,28,0,28,0,28,0,0,0,0
Dhaka,Gopalganj,Kotali Para,Pinjuri,33,0,33,0,33,0,0,0,0
Dhaka,Gopalganj,Kotali Para,###,356,6,350,0,350,0,5,0,1
Dhaka,Gopalganj,Kashiani,Kashiani,6,2,4,0,4,0,1,1,0
Dhaka,Gopalganj,Kashiani,Mamudpur,2,0,2,0,2,0,0,0,0
Dhaka,Gopalganj,Kashiani,Orakandi,1,1,0,0,0,0,1,0,0
Dhaka,Gopalganj,Kashiani,Ratail,1,1,0,0,0,0,1,0,0
Dhaka,Gopalganj,Kashiani,Bethuri,1,1,0,0,0,0,1,0,0
Dhaka,Gopalganj,Kashiani,Fukura,1,1,0,0,0,0,1,0,0
Dhaka,Gopalganj,Kashiani,Maheshpur,1,1,0,0,0,0,1,0,0
Dhaka,Gopalganj,Kashiani,Sajail,1,1,0,0,0,0,1,0,0
Dhaka,Gopalganj,Kashiani,Hatiara,0,0,0,0,0,0,0,0,0
Dhaka,Gopalganj,Kashiani,Nijamkandi,0,0,0,0,0,0,0,0,0
Dhaka,Gopalganj,Kashiani,Parulia,0,0,0,0,0,0,0,0,0
Dhaka,Gopalganj,Kashiani,Puisur,0,0,0,0,0,0,0,0,0
Dhaka,Gopalganj,Kashiani,Rajpat,0,0,0,0,0,0,0,0,0
Dhaka,Gopalganj,Kashiani,Singa,0,0,0,0,0,0,0,0,0
Dhaka,Gopalganj,Kashiani,###,14,8,6,0,6,0,7,1,0
Dhaka,Gopalganj,Tungi Para,Dumuria,4,1,3,0,3,0,1,0,0
Dhaka,Gopalganj,Tungi Para,Kushli,2,0,2,0,2,0,0,0,0
Dhaka,Gopalganj,Tungi Para,Gopalpur,3,1,2,0,2,0,1,0,0
Dhaka,Gopalganj,Tungi Para,Tungipara Paurashava,1,1,0,0,0,1,0,0,0
Dhaka,Gopalganj,Tungi Para,Patgati,1,1,0,0,0,0,1,0,0
Dhaka,Gopalganj,Tungi Para,Barni,1,1,0,0,0,0,1,0,0
Dhaka,Gopalganj,Tungi Para,###,12,5,7,0,7,1,4,0,0
Dhaka,Gopalganj,###,###,405,35,370,0,370,1,27,3,4
Dhaka,Madaripur,Rajoir,Isibpur,2,0,2,0,2,0,0,0,0
Dhaka,Madaripur,Rajoir,Bajitpur,2,1,1,0,1,0,1,0,0
Dhaka,Madaripur,Rajoir,Rajoir,4,1,3,0,3,0,0,1,0
Dhaka,Madaripur,Rajoir,Amgram,3,1,2,0,2,0,0,1,0
Dhaka,Madaripur,Rajoir,Khalia,4,2,2,0,2,0,0,2,0
Dhaka,Madaripur,Rajoir,Kabirajpur,1,1,0,0,0,0,1,0,0
Dhaka,Madaripur,Rajoir,Badar Pasha,2,2,0,0,0,0,2,0,0
Dhaka,Madaripur,Rajoir,Haridasdi Mahendradi,0,0,0,0,0,0,0,0,0
Dhaka,Madaripur,Rajoir,Hossainpur,0,0,0,0,0,0,0,0,0
Dhaka,Madaripur,Rajoir,Kadambari,0,0,0,0,0,0,0,0,0
Dhaka,Madaripur,Rajoir,Paik Para,0,0,0,0,0,0,0,0,0
Dhaka,Madaripur,Rajoir,###,18,8,10,0,10,0,4,4,0
Dhaka,Madaripur,Madaripur Sadar,Rasti,1,0,1,0,1,0,0,0,0
Dhaka,Madaripur,Madaripur Sadar,Jhaudi,2,0,2,0,2,0,0,0,0
Dhaka,Madaripur,Madaripur Sadar,Mustafapur,1,1,0,0,0,0,1,0,0
Dhaka,Madaripur,Madaripur Sadar,Kendua,1,1,0,0,0,0,1,0,0
Dhaka,Madaripur,Madaripur Sadar,Madaripur Paurashava,2,1,1,0,1,0,1,0,0
Dhaka,Madaripur,Madaripur Sadar,Panchkhola,1,1,0,0,0,0,1,0,0
Dhaka,Madaripur,Madaripur Sadar,Chilar Char,1,1,0,0,0,0,1,0,0
Dhaka,Madaripur,Madaripur Sadar,Dudkhali,1,1,0,0,0,0,1,0,0
Dhaka,Madaripur,Madaripur Sadar,Bahadurpur,0,0,0,0,0,0,0,0,0
Dhaka,Madaripur,Madaripur Sadar,Dhurail,0,0,0,0,0,0,0,0,0
Dhaka,Madaripur,Madaripur Sadar,Ghatmajhi,0,0,0,0,0,0,0,0,0
Dhaka,Madaripur,Madaripur Sadar,Kalikapur,0,0,0,0,0,0,0,0,0
Dhaka,Madaripur,Madaripur Sadar,Khoajpur,0,0,0,0,0,0,0,0,0
Dhaka,Madaripur,Madaripur Sadar,Kunia,0,0,0,0,0,0,0,0,0
Dhaka,Madaripur,Madaripur Sadar,Pearpur,0,0,0,0,0,0,0,0,0
Dhaka,Madaripur,Madaripur Sadar,Sirkhara,0,0,0,0,0,0,0,0,0
Dhaka,Madaripur,Madaripur Sadar,###,10,6,4,0,4,0,6,0,0
Dhaka,Madaripur,Shib Char,Sannyasir Char,2,1,1,0,1,0,1,0,0
Dhaka,Madaripur,Shib Char,Umedpur,2,1,1,0,1,0,1,0,0
Dhaka,Madaripur,Shib Char,Shib Char Paurashava,3,1,2,0,2,0,1,0,0
Dhaka,Madaripur,Shib Char,Datta Para,1,1,0,0,0,0,1,0,0
Dhaka,Madaripur,Shib Char,Matbarer Char,1,1,0,0,0,0,1,0,0
Dhaka,Madaripur,Shib Char,Panch Char,1,1,0,0,0,0,1,0,0
Dhaka,Madaripur,Shib Char,Banshkandi,1,1,0,0,0,0,1,0,0
Dhaka,Madaripur,Shib Char,Kanthalbari,1,1,0,0,0,0,0,1,0
Dhaka,Madaripur,Shib Char,Bandarkhola,0,0,0,0,0,0,0,0,0
Dhaka,Madaripur,Shib Char,Bayratala Dakshin,0,0,0,0,0,0,0,0,0
Dhaka,Madaripur,Shib Char,Bayratala Uttar,0,0,0,0,0,0,0,0,0
Dhaka,Madaripur,Shib Char,Bhadrasan,0,0,0,0,0,0,0,0,0
Dhaka,Madaripur,Shib Char,Bhandarikandi,0,0,0,0,0,0,0,0,0
Dhaka,Madaripur,Shib Char,Char Janajat,0,0,0,0,0,0,0,0,0
Dhaka,Madaripur,Shib Char,Ditiyakhanda,0,0,0,0,0,0,0,0,0
Dhaka,Madaripur,Shib Char,Kadirpur,0,0,0,0,0,0,0,0,0
Dhaka,Madaripur,Shib Char,Kutubpur,0,0,0,0,0,0,0,0,0
Dhaka,Madaripur,Shib Char,Nilakhi,0,0,0,0,0,0,0,0,0
Dhaka,Madaripur,Shib Char,Shibchar,0,0,0,0,0,0,0,0,0
Dhaka,Madaripur,Shib Char,Siruail,0,0,0,0,0,0,0,0,0
Dhaka,Madaripur,Shib Char,###,12,8,4,0,4,0,7,1,0
Dhaka,Madaripur,Kalkini,Dasar,2,0,2,0,2,0,0,0,0
Dhaka,Madaripur,Kalkini,Ramjanpur,1,0,1,0,1,0,0,0,0
Dhaka,Madaripur,Kalkini,Nabagram,14,0,14,0,14,0,0,0,0
Dhaka,Madaripur,Kalkini,Kalkini Paurashava,12,3,9,0,9,0,3,0,0
Dhaka,Madaripur,Kalkini,Enayetnagar,3,1,2,0,2,0,1,0,0
Dhaka,Madaripur,Kalkini,Kazibakai,1,1,0,0,0,0,0,1,0
Dhaka,Madaripur,Kalkini,Baligram,1,1,0,0,0,0,1,0,0
Dhaka,Madaripur,Kalkini,Char Daulat Khan,2,0,2,0,2,0,0,0,0
Dhaka,Madaripur,Kalkini,Gopalpur,1,0,1,0,1,0,0,0,0
Dhaka,Madaripur,Kalkini,Shikar Mangal,4,0,4,0,4,0,0,0,0
Dhaka,Madaripur,Kalkini,Alinagar,0,0,0,0,0,0,0,0,0
Dhaka,Madaripur,Kalkini,Banshgari,0,0,0,0,0,0,0,0,0
Dhaka,Madaripur,Kalkini,Kayaria,0,0,0,0,0,0,0,0,0
Dhaka,Madaripur,Kalkini,Lakshmipur,0,0,0,0,0,0,0,0,0
Dhaka,Madaripur,Kalkini,Sahebrampur,0,0,0,0,0,0,0,0,0
Dhaka,Madaripur,Kalkini,###,41,6,35,0,35,0,5,1,0
Dhaka,Madaripur,###,###,81,28,53,0,53,0,22,6,0
Dhaka,Narayanganj,Narayanganj Sadar,Fatullah (part),1,0,1,0,1,0,0,0,0
Dhaka,Narayanganj,Narayanganj Sadar,Narayanganj Paurashava,5,1,4,0,4,0,0,1,0
Dhaka,Narayanganj,Narayanganj Sadar,Siddirganj Paurashava,6,2,4,1,3,0,1,0,1
Dhaka,Narayanganj,Narayanganj Sadar,Kutubpur,1,1,0,0,0,0,0,1,0
Dhaka,Narayanganj,Narayanganj Sadar,Gognagar,1,1,0,0,0,0,0,1,0
Dhaka,Narayanganj,Narayanganj Sadar,Alir Tek,0,0,0,0,0,0,0,0,0
Dhaka,Narayanganj,Narayanganj Sadar,Baktaballi,0,0,0,0,0,0,0,0,0
Dhaka,Narayanganj,Narayanganj Sadar,Enayetnagar,0,0,0,0,0,0,0,0,0
Dhaka,Narayanganj,Narayanganj Sadar,Kashipur,0,0,0,0,0,0,0,0,0
Dhaka,Narayanganj,Narayanganj Sadar,###,14,5,9,1,8,0,1,3,1
Dhaka,Narayanganj,Sonargaon,Jampur,2,2,0,0,0,0,1,1,0
Dhaka,Narayanganj,Sonargaon,Sanmandi,1,1,0,0,0,0,0,1,0
Dhaka,Narayanganj,Sonargaon,Noagaon,3,1,2,0,2,0,1,0,0
Dhaka,Narayanganj,Sonargaon,Pirijpur,3,1,2,0,2,0,1,0,0
Dhaka,Narayanganj,Sonargaon,Baidyer Bazar,1,1,0,0,0,0,1,0,0
Dhaka,Narayanganj,Sonargaon,Sonargaon Paurashava,1,1,0,0,0,0,1,0,0
Dhaka,Narayanganj,Sonargaon,Mugra Para,2,0,2,0,2,0,0,0,0
Dhaka,Narayanganj,Sonargaon,Baradi,0,0,0,0,0,0,0,0,0
Dhaka,Narayanganj,Sonargaon,Kachpur,0,0,0,0,0,0,0,0,0
Dhaka,Narayanganj,Sonargaon,Sadipur,0,0,0,0,0,0,0,0,0
Dhaka,Narayanganj,Sonargaon,Shambhupura,0,0,0,0,0,0,0,0,0
Dhaka,Narayanganj,Sonargaon,###,13,7,6,0,6,0,5,2,0
Dhaka,Narayanganj,Rupganj,Mura Para,1,1,0,0,0,0,0,1,0
Dhaka,Narayanganj,Rupganj,Tarabo Paurashava,3,3,0,0,0,0,2,1,0
Dhaka,Narayanganj,Rupganj,Kanchan Paurashava,1,1,0,0,0,1,0,0,0
Dhaka,Narayanganj,Rupganj,Daudpur,1,1,0,0,0,0,0,1,0
Dhaka,Narayanganj,Rupganj,Bholaba,1,1,0,0,0,0,1,0,0
Dhaka,Narayanganj,Rupganj,Bulta,0,0,0,0,0,0,0,0,0
Dhaka,Narayanganj,Rupganj,Golakandail,0,0,0,0,0,0,0,0,0
Dhaka,Narayanganj,Rupganj,Kayet Para,0,0,0,0,0,0,0,0,0
Dhaka,Narayanganj,Rupganj,Rupganj,0,0,0,0,0,0,0,0,0
Dhaka,Narayanganj,Rupganj,###,7,7,0,0,0,1,3,3,0
Dhaka,Narayanganj,Bandar,Madanpur,1,1,0,0,0,0,1,0,0
Dhaka,Narayanganj,Bandar,Kadam Rasul Paurashava,2,2,0,0,0,0,0,1,1
Dhaka,Narayanganj,Bandar,Kalagachhia,6,0,6,0,6,0,0,0,0
Dhaka,Narayanganj,Bandar,Bandar,0,0,0,0,0,0,0,0,0
Dhaka,Narayanganj,Bandar,Dhamgar,0,0,0,0,0,0,0,0,0
Dhaka,Narayanganj,Bandar,Musapur,0,0,0,0,0,0,0,0,0
Dhaka,Narayanganj,Bandar,###,9,3,6,0,6,0,1,1,1
Dhaka,Narayanganj,Araihazar,Mahmudpur,1,1,0,0,0,1,0,0,0
Dhaka,Narayanganj,Araihazar,Fatehpur,1,1,0,0,0,0,1,0,0
Dhaka,Narayanganj,Araihazar,Satgram,1,1,0,0,0,0,1,0,0
Dhaka,Narayanganj,Araihazar,Araihazar,1,1,0,0,0,0,1,0,0
Dhaka,Narayanganj,Araihazar,Haizadi,1,1,0,0,0,0,1,0,0
Dhaka,Narayanganj,Araihazar,Duptara,1,1,0,0,0,0,1,0,0
Dhaka,Narayanganj,Araihazar,Brahmandi,1,0,1,0,1,0,0,0,0
Dhaka,Narayanganj,Araihazar,Bishnandi,0,0,0,0,0,0,0,0,0
Dhaka,Narayanganj,Araihazar,Kala Paharia,0,0,0,0,0,0,0,0,0
Dhaka,Narayanganj,Araihazar,Khagakanda,0,0,0,0,0,0,0,0,0
Dhaka,Narayanganj,Araihazar,Sadasardi,0,0,0,0,0,0,0,0,0
Dhaka,Narayanganj,Araihazar,Uchitpur,0,0,0,0,0,0,0,0,0
Dhaka,Narayanganj,Araihazar,###,7,6,1,0,1,1,5,0,0
Dhaka,Narayanganj,###,###,50,28,22,1,21,2,15,9,2
Dhaka,Narsingdi,Shibpur,Ayubpur,6,0,6,0,6,0,0,0,0
Dhaka,Narsingdi,Shibpur,Putia,5,2,3,0,3,0,2,0,0
Dhaka,Narsingdi,Shibpur,Josar,1,1,0,0,0,0,1,0,0
Dhaka,Narsingdi,Shibpur,Chak Radha,1,1,0,0,0,0,0,1,0
Dhaka,Narsingdi,Shibpur,Joynagar,1,1,0,0,0,0,0,1,0
Dhaka,Narsingdi,Shibpur,Baghaba,1,1,0,0,0,0,1,0,0
Dhaka,Narsingdi,Shibpur,Masimpur,2,2,0,0,0,1,1,0,0
Dhaka,Narsingdi,Shibpur,Shibpur Paurashava,1,1,0,0,0,0,1,0,0
Dhaka,Narsingdi,Shibpur,Sadhar Char,1,1,0,0,0,0,1,0,0
Dhaka,Narsingdi,Shibpur,Dulalpur,1,1,0,0,0,0,0,1,0
Dhaka,Narsingdi,Shibpur,###,20,11,9,0,9,1,7,3,0
Dhaka,Narsingdi,Manohardi,Bara Chapa,3,1,2,0,2,0,1,0,0
Dhaka,Narsingdi,Manohardi,Ekduaria,3,1,2,0,2,0,1,0,0
Dhaka,Narsingdi,Manohardi,Shukundi,2,0,2,0,2,0,0,0,0
Dhaka,Narsingdi,Manohardi,Manohardi Paurashava,1,1,0,0,0,0,0,1,0
Dhaka,Narsingdi,Manohardi,Kanchikata,1,1,0,0,0,0,0,1,0
Dhaka,Narsingdi,Manohardi,Gotashia,1,1,0,0,0,0,1,0,0
Dhaka,Narsingdi,Manohardi,Khidirpur,1,1,0,0,0,1,0,0,0
Dhaka,Narsingdi,Manohardi,Daulatpur,1,1,0,0,0,0,1,0,0
Dhaka,Narsingdi,Manohardi,Lebutala,1,1,0,0,0,0,1,0,0
Dhaka,Narsingdi,Manohardi,Chandanbari,1,1,0,0,0,1,0,0,0
Dhaka,Narsingdi,Manohardi,Chalak Char,0,0,0,0,0,0,0,0,0
Dhaka,Narsingdi,Manohardi,Char Mandalia,0,0,0,0,0,0,0,0,0
Dhaka,Narsingdi,Manohardi,###,15,9,6,0,6,2,5,2,0
Dhaka,Narsingdi,Narsingdi Sadar,Narsingdi Paurashava,1,1,0,0,0,0,0,0,1
Dhaka,Narsingdi,Narsingdi Sadar,Amdia,1,1,0,0,0,0,0,1,0
Dhaka,Narsingdi,Narsingdi Sadar,Panchdona,1,1,0,0,0,0,1,0,0
Dhaka,Narsingdi,Narsingdi Sadar,Madhabdi Paurashava,1,1,0,0,0,1,0,0,0
Dhaka,Narsingdi,Narsingdi Sadar,Meher Para,1,1,0,0,0,0,1,0,0
Dhaka,Narsingdi,Narsingdi Sadar,Hajipur,1,1,0,0,0,0,1,0,0
Dhaka,Narsingdi,Narsingdi Sadar,Alokbali,1,1,0,0,0,0,1,0,0
Dhaka,Narsingdi,Narsingdi Sadar,Kanthalia,1,1,0,0,0,0,1,0,0
Dhaka,Narsingdi,Narsingdi Sadar,Karimpur,1,1,0,0,0,0,1,0,0
Dhaka,Narsingdi,Narsingdi Sadar,Char Dighaldi,0,0,0,0,0,0,0,0,0
Dhaka,Narsingdi,Narsingdi Sadar,Chinishpur,0,0,0,0,0,0,0,0,0
Dhaka,Narsingdi,Narsingdi Sadar,Mahishasura,0,0,0,0,0,0,0,0,0
Dhaka,Narsingdi,Narsingdi Sadar,Nazarpur,0,0,0,0,0,0,0,0,0
Dhaka,Narsingdi,Narsingdi Sadar,Nuralla Pur U/C,0,0,0,0,0,0,0,0,0
Dhaka,Narsingdi,Narsingdi Sadar,Paikar Char,0,0,0,0,0,0,0,0,0
Dhaka,Narsingdi,Narsingdi Sadar,Silmandi,0,0,0,0,0,0,0,0,0
Dhaka,Narsingdi,Narsingdi Sadar,###,9,9,0,0,0,1,6,1,1
Dhaka,Narsingdi,Palash,Jinardi,2,2,0,0,0,0,1,0,1
Dhaka,Narsingdi,Palash,Char Sindur,2,2,0,0,0,0,1,1,0
Dhaka,Narsingdi,Palash,Gazaria,1,1,0,0,0,0,1,0,0
Dhaka,Narsingdi,Palash,Danga,0,0,0,0,0,0,0,0,0
Dhaka,Narsingdi,Palash,Ghorashal Paurashava,0,0,0,0,0,0,0,0,0
Dhaka,Narsingdi,Palash,###,5,5,0,0,0,0,3,1,1
Dhaka,Narsingdi,Roypura,Chanderkandi,1,1,0,0,0,1,0,0,0
Dhaka,Narsingdi,Roypura,Uttar Bakharnagar,1,1,0,0,0,0,1,0,0
Dhaka,Narsingdi,Roypura,Banshgari,1,1,0,0,0,0,1,0,0
Dhaka,Narsingdi,Roypura,Amirganj,1,1,0,0,0,0,1,0,0
Dhaka,Narsingdi,Roypura,Radhanagar,1,1,0,0,0,0,1,0,0
Dhaka,Narsingdi,Roypura,Chandpur,1,1,0,0,0,0,1,0,0
Dhaka,Narsingdi,Roypura,Roypura Paurashava,1,1,0,0,0,0,1,0,0
Dhaka,Narsingdi,Roypura,Nilakhya,1,1,0,0,0,0,1,0,0
Dhaka,Narsingdi,Roypura,Musapur,1,1,0,0,0,0,1,0,0
Dhaka,Narsingdi,Roypura,Sreenagar,1,1,0,0,0,0,1,0,0
Dhaka,Narsingdi,Roypura,Palashtali,1,1,0,0,0,0,1,0,0
Dhaka,Narsingdi,Roypura,Adiabad,0,0,0,0,0,0,0,0,0
Dhaka,Narsingdi,Roypura,Alipura,0,0,0,0,0,0,0,0,0
Dhaka,Narsingdi,Roypura,Char Aralia,0,0,0,0,0,0,0,0,0
Dhaka,Narsingdi,Roypura,Char Madhua,0,0,0,0,0,0,0,0,0
Dhaka,Narsingdi,Roypura,Char Subuddi,0,0,0,0,0,0,0,0,0
Dhaka,Narsingdi,Roypura,Daukar Char,0,0,0,0,0,0,0,0,0
Dhaka,Narsingdi,Roypura,Hairmara,0,0,0,0,0,0,0,0,0
Dhaka,Narsingdi,Roypura,Maheshpur,0,0,0,0,0,0,0,0,0
Dhaka,Narsingdi,Roypura,Marjal,0,0,0,0,0,0,0,0,0
Dhaka,Narsingdi,Roypura,Mirzanagar,0,0,0,0,0,0,0,0,0
Dhaka,Narsingdi,Roypura,Mirzapur,0,0,0,0,0,0,0,0,0
Dhaka,Narsingdi,Roypura,Mirzar Char,0,0,0,0,0,0,0,0,0
Dhaka,Narsingdi,Roypura,Paratali,0,0,0,0,0,0,0,0,0
Dhaka,Narsingdi,Roypura,Roypura,0,0,0,0,0,0,0,0,0
Dhaka,Narsingdi,Roypura,###,11,11,0,0,0,1,10,0,0
Dhaka,Narsingdi,Belabo,Amlaba,1,1,0,0,0,0,0,1,0
Dhaka,Narsingdi,Belabo,Belabo,1,1,0,0,0,0,0,1,0
Dhaka,Narsingdi,Belabo,Patuli,2,2,0,0,0,0,1,1,0
Dhaka,Narsingdi,Belabo,Binyabaid,2,2,0,0,0,0,1,1,0
Dhaka,Narsingdi,Belabo,Narayanpur,1,1,0,0,0,0,1,0,0
Dhaka,Narsingdi,Belabo,Sallabad,1,1,0,0,0,0,1,0,0
Dhaka,Narsingdi,Belabo,Bajnaba,0,0,0,0,0,0,0,0,0
Dhaka,Narsingdi,Belabo,Char Ujilaba,0,0,0,0,0,0,0,0,0
Dhaka,Narsingdi,Belabo,###,8,8,0,0,0,0,4,4,0
Dhaka,Narsingdi,###,###,68,53,15,0,15,5,35,11,2
Dhaka,Tangail,Ghatail,Rasulpur,4,2,2,0,2,0,1,1,0
Dhaka,Tangail,Ghatail,Deopara,1,1,0,0,0,0,0,1,0
Dhaka,Tangail,Ghatail,Dhala Para,1,1,0,0,0,0,0,1,0
Dhaka,Tangail,Ghatail,Sandhanpur,2,2,0,0,0,0,1,1,0
Dhaka,Tangail,Ghatail,Lakher Para,1,1,0,0,0,0,1,0,0
Dhaka,Tangail,Ghatail,Digar,1,1,0,0,0,0,1,0,0
Dhaka,Tangail,Ghatail,Deulabari,1,1,0,0,0,0,1,0,0
Dhaka,Tangail,Ghatail,Ghatail Paurashava,1,1,0,0,0,0,1,0,0
Dhaka,Tangail,Ghatail,Anehola,0,0,0,0,0,0,0,0,0
Dhaka,Tangail,Ghatail,Digalkandi,0,0,0,0,0,0,0,0,0
Dhaka,Tangail,Ghatail,Ghatail,0,0,0,0,0,0,0,0,0
Dhaka,Tangail,Ghatail,Jamuria,0,0,0,0,0,0,0,0,0
Dhaka,Tangail,Ghatail,###,12,10,2,0,2,0,6,4,0
Dhaka,Tangail,Sakhipur,Gazaria,2,2,0,0,0,0,1,0,1
Dhaka,Tangail,Sakhipur,Baheratail,1,1,0,0,0,0,0,1,0
Dhaka,Tangail,Sakhipur,Hatibandha,1,1,0,0,0,0,0,1,0
Dhaka,Tangail,Sakhipur,Jadabpur,1,1,0,0,0,0,0,1,0
Dhaka,Tangail,Sakhipur,Sakhipur Paurashava,1,1,0,0,0,0,0,1,0
Dhaka,Tangail,Sakhipur,Kalia,1,1,0,0,0,0,0,1,0
Dhaka,Tangail,Sakhipur,Kakrajan,0,0,0,0,0,0,0,0,0
Dhaka,Tangail,Sakhipur,###,7,7,0,0,0,0,1,5,1
Dhaka,Tangail,Mirzapur,Gorai,1,1,0,0,0,0,0,1,0
Dhaka,Tangail,Mirzapur,Mirzapur Paurashava,2,2,0,0,0,0,1,1,0
Dhaka,Tangail,Mirzapur,Ajgana,2,2,0,0,0,0,1,1,0
Dhaka,Tangail,Mirzapur,Fatehpur,1,1,0,0,0,0,1,0,0
Dhaka,Tangail,Mirzapur,Bahuria,1,1,0,0,0,0,0,1,0
Dhaka,Tangail,Mirzapur,Anaitara,2,2,0,0,0,0,2,0,0
Dhaka,Tangail,Mirzapur,Jamurki,1,1,0,0,0,0,1,0,0
Dhaka,Tangail,Mirzapur,Mahera,1,1,0,0,0,0,1,0,0
Dhaka,Tangail,Mirzapur,Uarsi,2,2,0,0,0,0,2,0,0
Dhaka,Tangail,Mirzapur,Banail,0,0,0,0,0,0,0,0,0
Dhaka,Tangail,Mirzapur,Banshtail,0,0,0,0,0,0,0,0,0
Dhaka,Tangail,Mirzapur,Bhaora,0,0,0,0,0,0,0,0,0
Dhaka,Tangail,Mirzapur,Bhatgram,0,0,0,0,0,0,0,0,0
Dhaka,Tangail,Mirzapur,Latifpur,0,0,0,0,0,0,0,0,0
Dhaka,Tangail,Mirzapur,Tarafpur,0,0,0,0,0,0,0,0,0
Dhaka,Tangail,Mirzapur,###,13,13,0,0,0,0,9,4,0
Dhaka,Tangail,Madhupur,Arankhola,1,1,0,0,0,0,1,0,0
Dhaka,Tangail,Madhupur,Alokdia,1,1,0,0,0,0,1,0,0
Dhaka,Tangail,Madhupur,Ausnara,1,1,0,0,0,0,1,0,0
Dhaka,Tangail,Madhupur,Madhupur Paurashava,1,1,0,0,0,0,1,0,0
Dhaka,Tangail,Madhupur,Golabari,0,0,0,0,0,0,0,0,0
Dhaka,Tangail,Madhupur,Mirzabari,0,0,0,0,0,0,0,0,0
Dhaka,Tangail,Madhupur,Solakuri,0,0,0,0,0,0,0,0,0
Dhaka,Tangail,Madhupur,###,4,4,0,0,0,0,4,0,0
Dhaka,Tangail,Basail,Kashil,1,1,0,0,0,0,1,0,0
Dhaka,Tangail,Basail,Basail,3,3,0,0,0,0,3,0,0
Dhaka,Tangail,Basail,Kaoaljani,1,1,0,0,0,0,1,0,0
Dhaka,Tangail,Basail,Fulki,1,1,0,0,0,0,1,0,0
Dhaka,Tangail,Basail,Habla,0,0,0,0,0,0,0,0,0
Dhaka,Tangail,Basail,Kanchanpur,0,0,0,0,0,0,0,0,0
Dhaka,Tangail,Basail,###,6,6,0,0,0,0,6,0,0
Dhaka,Tangail,Bhuapur,Gobindasi,3,3,0,0,0,0,3,0,0
Dhaka,Tangail,Bhuapur,Arjuna,1,1,0,0,0,0,1,0,0
Dhaka,Tangail,Bhuapur,Falda,1,1,0,0,0,0,1,0,0
Dhaka,Tangail,Bhuapur,Birhati,1,1,0,0,0,0,1,0,0
Dhaka,Tangail,Bhuapur,Nikrail,1,1,0,0,0,0,1,0,0
Dhaka,Tangail,Bhuapur,Bhuapur Paurashava,0,0,0,0,0,0,0,0,0
Dhaka,Tangail,Bhuapur,Gabsara,0,0,0,0,0,0,0,0,0
Dhaka,Tangail,Bhuapur,###,7,7,0,0,0,0,7,0,0
Dhaka,Tangail,Tangail Sadar,Katuli,1,1,0,0,0,0,1,0,0
Dhaka,Tangail,Tangail Sadar,Karatia,2,2,0,0,0,0,2,0,0
Dhaka,Tangail,Tangail Sadar,Danya,2,2,0,0,0,0,2,0,0
Dhaka,Tangail,Tangail Sadar,Tangail Paurashava,2,2,0,0,0,0,2,0,0
Dhaka,Tangail,Tangail Sadar,Silimpur,1,1,0,0,0,0,1,0,0
Dhaka,Tangail,Tangail Sadar,Gharinda,1,1,0,0,0,0,1,0,0
Dhaka,Tangail,Tangail Sadar,Magra,1,1,0,0,0,0,1,0,0
Dhaka,Tangail,Tangail Sadar,Porabari,1,1,0,0,0,0,1,0,0
Dhaka,Tangail,Tangail Sadar,Gala,1,1,0,0,0,0,0,1,0
Dhaka,Tangail,Tangail Sadar,Baghil,0,0,0,0,0,0,0,0,0
Dhaka,Tangail,Tangail Sadar,Hugra,0,0,0,0,0,0,0,0,0
Dhaka,Tangail,Tangail Sadar,Kakua,0,0,0,0,0,0,0,0,0
Dhaka,Tangail,Tangail Sadar,Mahamudnagar,0,0,0,0,0,0,0,0,0
Dhaka,Tangail,Tangail Sadar,###,12,12,0,0,0,0,11,1,0
Dhaka,Tangail,Gopalpur,Jhawail,1,1,0,0,0,0,1,0,0
Dhaka,Tangail,Gopalpur,Hadira,1,1,0,0,0,0,1,0,0
Dhaka,Tangail,Gopalpur,Mirzapur,1,1,0,0,0,0,1,0,0
Dhaka,Tangail,Gopalpur,Alamnagar,1,1,0,0,0,0,1,0,0
Dhaka,Tangail,Gopalpur,Hemnagar,1,1,0,0,0,0,1,0,0
Dhaka,Tangail,Gopalpur,Gopalpur Paurashava,1,1,0,0,0,0,0,0,1
Dhaka,Tangail,Gopalpur,Nagda Simla,1,1,0,0,0,0,1,0,0
Dhaka,Tangail,Gopalpur,Dhopakandi,1,1,0,0,0,0,1,0,0
Dhaka,Tangail,Gopalpur,###,8,8,0,0,0,0,7,0,1
Dhaka,Tangail,Dhanbari,Dhanbari Paurashava,1,1,0,0,0,0,1,0,0
Dhaka,Tangail,Dhanbari,Birtara,1,1,0,0,0,0,1,0,0
Dhaka,Tangail,Dhanbari,Dhopakhali,1,1,0,0,0,0,1,0,0
Dhaka,Tangail,Dhanbari,Balibhadra,0,0,0,0,0,0,0,0,0
Dhaka,Tangail,Dhanbari,Baniajan,0,0,0,0,0,0,0,0,0
Dhaka,Tangail,Dhanbari,Dhanbari,0,0,0,0,0,0,0,0,0
Dhaka,Tangail,Dhanbari,Musuddi,0,0,0,0,0,0,0,0,0
Dhaka,Tangail,Dhanbari,Paiska,0,0,0,0,0,0,0,0,0
Dhaka,Tangail,Dhanbari,###,3,3,0,0,0,0,3,0,0
Dhaka,Tangail,Nagarpur,Dhubaria,2,2,0,0,0,0,2,0,0
Dhaka,Tangail,Nagarpur,Salimabad,1,1,0,0,0,0,1,0,0
Dhaka,Tangail,Nagarpur,Nagarpur,2,2,0,0,0,0,2,0,0
Dhaka,Tangail,Nagarpur,Sahabatpur,1,1,0,0,0,0,1,0,0
Dhaka,Tangail,Nagarpur,Bekra,0,0,0,0,0,0,0,0,0
Dhaka,Tangail,Nagarpur,Bhadra,0,0,0,0,0,0,0,0,0
Dhaka,Tangail,Nagarpur,Bhara,0,0,0,0,0,0,0,0,0
Dhaka,Tangail,Nagarpur,Duptiair,0,0,0,0,0,0,0,0,0
Dhaka,Tangail,Nagarpur,Gayhata,0,0,0,0,0,0,0,0,0
Dhaka,Tangail,Nagarpur,Mamudnagar,0,0,0,0,0,0,0,0,0
Dhaka,Tangail,Nagarpur,Mokhna,0,0,0,0,0,0,0,0,0
Dhaka,Tangail,Nagarpur,Pakutia,0,0,0,0,0,0,0,0,0
Dhaka,Tangail,Nagarpur,###,6,6,0,0,0,0,6,0,0
Dhaka,Tangail,Kalihati,Elenga,1,1,0,0,0,0,1,0,0
Dhaka,Tangail,Kalihati,Salla,1,1,0,0,0,0,1,0,0
Dhaka,Tangail,Kalihati,Kalihati Paurashava,3,2,1,1,0,0,1,1,0
Dhaka,Tangail,Kalihati,Narandia,1,1,0,0,0,0,1,0,0
Dhaka,Tangail,Kalihati,Balla,1,1,0,0,0,0,1,0,0
Dhaka,Tangail,Kalihati,Parki,1,1,0,0,0,0,1,0,0
Dhaka,Tangail,Kalihati,Bangra,1,1,0,0,0,0,1,0,0
Dhaka,Tangail,Kalihati,Bir Basunda,0,0,0,0,0,0,0,0,0
Dhaka,Tangail,Kalihati,Dashkia,0,0,0,0,0,0,0,0,0
Dhaka,Tangail,Kalihati,Durgapur,0,0,0,0,0,0,0,0,0
Dhaka,Tangail,Kalihati,Gohaliabari,0,0,0,0,0,0,0,0,0
Dhaka,Tangail,Kalihati,Kok Dahara,0,0,0,0,0,0,0,0,0
Dhaka,Tangail,Kalihati,Nagbari,0,0,0,0,0,0,0,0,0
Dhaka,Tangail,Kalihati,Paikara,0,0,0,0,0,0,0,0,0
Dhaka,Tangail,Kalihati,Sahadebpur,0,0,0,0,0,0,0,0,0
Dhaka,Tangail,Kalihati,###,9,8,1,1,0,0,7,1,0
Dhaka,Tangail,Delduar,Elasin,1,1,0,0,0,0,1,0,0
Dhaka,Tangail,Delduar,Dubail,1,1,0,0,0,0,1,0,0
Dhaka,Tangail,Delduar,Delduar,1,1,0,0,0,0,1,0,0
Dhaka,Tangail,Delduar,Pathrail,2,2,0,0,0,0,2,0,0
Dhaka,Tangail,Delduar,Atia,0,0,0,0,0,0,0,0,0
Dhaka,Tangail,Delduar,Deoli,0,0,0,0,0,0,0,0,0
Dhaka,Tangail,Delduar,Fazilhati,0,0,0,0,0,0,0,0,0
Dhaka,Tangail,Delduar,Lauhati,0,0,0,0,0,0,0,0,0
Dhaka,Tangail,Delduar,###,5,5,0,0,0,0,5,0,0
Dhaka,Tangail,###,###,92,89,3,1,2,0,72,15,2
Dhaka,Munshiganj,Lohajang,Haldia,5,1,4,0,4,0,0,1,0
Dhaka,Munshiganj,Lohajang,Lohajang Teotia,5,2,3,1,2,0,0,1,1
Dhaka,Munshiganj,Lohajang,Medini Mandal,1,1,0,0,0,0,0,1,0
Dhaka,Munshiganj,Lohajang,Gaodia,1,1,0,0,0,0,1,0,0
Dhaka,Munshiganj,Lohajang,Kumarbhog,1,1,0,0,0,0,0,1,0
Dhaka,Munshiganj,Lohajang,Baultali,0,0,0,0,0,0,0,0,0
Dhaka,Munshiganj,Lohajang,Bejgaon,0,0,0,0,0,0,0,0,0
Dhaka,Munshiganj,Lohajang,Kalma,0,0,0,0,0,0,0,0,0
Dhaka,Munshiganj,Lohajang,Kanaksar,0,0,0,0,0,0,0,0,0
Dhaka,Munshiganj,Lohajang,Khidir Para,0,0,0,0,0,0,0,0,0
Dhaka,Munshiganj,Lohajang,###,13,6,7,1,6,0,1,4,1
Dhaka,Munshiganj,Serajdikhan,Balur Char,2,0,2,0,2,0,0,0,0
Dhaka,Munshiganj,Serajdikhan,Rasunia,4,1,3,1,2,0,0,1,0
Dhaka,Munshiganj,Serajdikhan,Kayain,1,1,0,0,0,0,0,0,1
Dhaka,Munshiganj,Serajdikhan,Rajanagar,1,1,0,0,0,0,0,1,0
Dhaka,Munshiganj,Serajdikhan,Basail,1,1,0,0,0,0,0,1,0
Dhaka,Munshiganj,Serajdikhan,Malkhanagar,1,1,0,0,0,0,0,0,1
Dhaka,Munshiganj,Serajdikhan,Bayaragadi,1,1,0,0,0,0,0,1,0
Dhaka,Munshiganj,Serajdikhan,Madhyapara,1,1,0,0,0,0,0,1,0
Dhaka,Munshiganj,Serajdikhan,Chitrakot,0,0,0,0,0,0,0,0,0
Dhaka,Munshiganj,Serajdikhan,Ichhapur,0,0,0,0,0,0,0,0,0
Dhaka,Munshiganj,Serajdikhan,Jainsar,0,0,0,0,0,0,0,0,0
Dhaka,Munshiganj,Serajdikhan,Kola,0,0,0,0,0,0,0,0,0
Dhaka,Munshiganj,Serajdikhan,Latabdi,0,0,0,0,0,0,0,0,0
Dhaka,Munshiganj,Serajdikhan,Sekharnagar,0,0,0,0,0,0,0,0,0
Dhaka,Munshiganj,Serajdikhan,###,12,7,5,1,4,0,0,5,2
Dhaka,Munshiganj,Gazaria,Tenger Char,1,0,1,0,1,0,0,0,0
Dhaka,Munshiganj,Gazaria,Bausia,1,1,0,0,0,0,1,0,0
Dhaka,Munshiganj,Gazaria,Gazaria,2,1,1,0,1,1,0,0,0
Dhaka,Munshiganj,Gazaria,Bhaber Char,3,1,2,0,2,0,1,0,0
Dhaka,Munshiganj,Gazaria,Hossaindi,7,1,6,0,6,0,0,1,0
Dhaka,Munshiganj,Gazaria,Imampur,3,1,2,0,2,0,1,0,0
Dhaka,Munshiganj,Gazaria,Baluakandi,1,1,0,0,0,0,1,0,0
Dhaka,Munshiganj,Gazaria,Guagachhia,0,0,0,0,0,0,0,0,0
Dhaka,Munshiganj,Gazaria,###,18,6,12,0,12,1,4,1,0
Dhaka,Munshiganj,Munshiganj Sadar,Munshiganj Paurashava,2,1,1,1,0,0,0,0,1
Dhaka,Munshiganj,Munshiganj Sadar,Rampal,1,1,0,0,0,0,0,1,0
Dhaka,Munshiganj,Munshiganj Sadar,Char Kewar,1,1,0,0,0,0,0,0,1
Dhaka,Munshiganj,Munshiganj Sadar,Panchasar,1,1,0,0,0,0,0,0,1
Dhaka,Munshiganj,Munshiganj Sadar,Mahakali,2,2,0,0,0,0,1,1,0
Dhaka,Munshiganj,Munshiganj Sadar,Mollahkandi,1,1,0,0,0,0,0,0,1
Dhaka,Munshiganj,Munshiganj Sadar,Silai,1,1,0,0,0,0,1,0,0
Dhaka,Munshiganj,Munshiganj Sadar,Bangla Bazar,5,0,5,0,5,0,0,0,0
Dhaka,Munshiganj,Munshiganj Sadar,Adhara,0,0,0,0,0,0,0,0,0
Dhaka,Munshiganj,Munshiganj Sadar,Bajra Jogini,0,0,0,0,0,0,0,0,0
Dhaka,Munshiganj,Munshiganj Sadar,Mirkadim Paurashava,0,0,0,0,0,0,0,0,0
Dhaka,Munshiganj,Munshiganj Sadar,###,14,8,6,1,5,0,2,2,4
Dhaka,Munshiganj,Tongibari,Dhipur,2,2,0,0,0,0,0,2,0
Dhaka,Munshiganj,Tongibari,Kamarkhara,1,1,0,0,0,0,1,0,0
Dhaka,Munshiganj,Tongibari,Jashalong,1,1,0,0,0,0,0,1,0
Dhaka,Munshiganj,Tongibari,Panchgaon,1,1,0,0,0,0,1,0,0
Dhaka,Munshiganj,Tongibari,Arial,1,1,0,0,0,0,0,1,0
Dhaka,Munshiganj,Tongibari,Abdullahpur,1,1,0,0,0,0,0,1,0
Dhaka,Munshiganj,Tongibari,Sonarang Tongibari,1,1,0,0,0,0,0,1,0
Dhaka,Munshiganj,Tongibari,Autshahi,0,0,0,0,0,0,0,0,0
Dhaka,Munshiganj,Tongibari,Betka,0,0,0,0,0,0,0,0,0
Dhaka,Munshiganj,Tongibari,Dighir Para,0,0,0,0,0,0,0,0,0
Dhaka,Munshiganj,Tongibari,Hasail Banari,0,0,0,0,0,0,0,0,0
Dhaka,Munshiganj,Tongibari,Kathadia Shimulia,0,0,0,0,0,0,0,0,0
Dhaka,Munshiganj,Tongibari,###,8,8,0,0,0,0,2,6,0
Dhaka,Munshiganj,Sreenagar,Baghra,1,1,0,0,0,0,0,1,0
Dhaka,Munshiganj,Sreenagar,Sholaghar,1,1,0,0,0,0,0,1,0
Dhaka,Munshiganj,Sreenagar,Bhagyakul,1,1,0,0,0,0,0,1,0
Dhaka,Munshiganj,Sreenagar,Hasara,1,1,0,0,0,0,0,1,0
Dhaka,Munshiganj,Sreenagar,Patabhog,6,2,4,0,4,0,1,1,0
Dhaka,Munshiganj,Sreenagar,Rarikhal,1,1,0,0,0,0,0,0,1
Dhaka,Munshiganj,Sreenagar,Tantar,1,1,0,0,0,0,0,1,0
Dhaka,Munshiganj,Sreenagar,Atpara,0,0,0,0,0,0,0,0,0
Dhaka,Munshiganj,Sreenagar,Baraikhali,0,0,0,0,0,0,0,0,0
Dhaka,Munshiganj,Sreenagar,Birtara,0,0,0,0,0,0,0,0,0
Dhaka,Munshiganj,Sreenagar,Kola Para,0,0,0,0,0,0,0,0,0
Dhaka,Munshiganj,Sreenagar,Kukutia,0,0,0,0,0,0,0,0,0
Dhaka,Munshiganj,Sreenagar,Shyamsiddhi,0,0,0,0,0,0,0,0,0
Dhaka,Munshiganj,Sreenagar,Sreenagar,0,0,0,0,0,0,0,0,0
Dhaka,Munshiganj,Sreenagar,###,12,8,4,0,4,0,1,6,1
Dhaka,Munshiganj,###,###,77,43,34,3,31,1,10,24,8
Dhaka,Faridpur,Madhukhali,Bagat,1,0,1,0,1,0,0,0,0
Dhaka,Faridpur,Madhukhali,Madhukhali,2,1,1,0,1,0,0,1,0
Dhaka,Faridpur,Madhukhali,Raipur,2,1,1,0,1,0,1,0,0
Dhaka,Faridpur,Madhukhali,Gajna,1,1,0,0,0,0,0,0,1
Dhaka,Faridpur,Madhukhali,Dumain,1,1,0,0,0,0,0,1,0
Dhaka,Faridpur,Madhukhali,Noapara,1,1,0,0,0,0,0,1,0
Dhaka,Faridpur,Madhukhali,Kamarkhali,1,1,0,0,0,0,0,1,0
Dhaka,Faridpur,Madhukhali,Megchami,1,1,0,0,0,0,0,0,1
Dhaka,Faridpur,Madhukhali,Jahapur,0,0,0,0,0,0,0,0,0
Dhaka,Faridpur,Madhukhali,###,10,7,3,0,3,0,1,4,2
Dhaka,Faridpur,Nagarkanda,Char Jasordi,2,1,1,0,1,0,1,0,0
Dhaka,Faridpur,Nagarkanda,Nagarkanda Paurashava,2,1,1,0,1,0,1,0,0
Dhaka,Faridpur,Nagarkanda,Talma,2,2,0,0,0,0,2,0,0
Dhaka,Faridpur,Nagarkanda,Laskardia,1,1,0,0,0,0,1,0,0
Dhaka,Faridpur,Nagarkanda,Dangi,1,1,0,0,0,0,1,0,0
Dhaka,Faridpur,Nagarkanda,Kaichail,1,1,0,0,0,0,1,0,0
Dhaka,Faridpur,Nagarkanda,Pura Para,1,1,0,0,0,0,1,0,0
Dhaka,Faridpur,Nagarkanda,Ramnagar,2,2,0,0,0,1,1,0,0
Dhaka,Faridpur,Nagarkanda,Kodalia Shohidnagar,0,0,0,0,0,0,0,0,0
Dhaka,Faridpur,Nagarkanda,Phulsuti,0,0,0,0,0,0,0,0,0
Dhaka,Faridpur,Nagarkanda,###,12,10,2,0,2,1,9,0,0
Dhaka,Faridpur,Sadarpur,Bhashanchar,2,1,1,0,1,0,1,0,0
Dhaka,Faridpur,Sadarpur,Krishnapur,1,0,1,0,1,0,0,0,0
Dhaka,Faridpur,Sadarpur,Sadarpur,4,1,3,3,0,0,1,0,0
Dhaka,Faridpur,Sadarpur,Akter Char,1,1,0,0,0,0,1,0,0
Dhaka,Faridpur,Sadarpur,Char Bishnupur,1,1,0,0,0,0,1,0,0
Dhaka,Faridpur,Sadarpur,Dheukhali,1,1,0,0,0,0,1,0,0
Dhaka,Faridpur,Sadarpur,Char Manair,0,0,0,0,0,0,0,0,0
Dhaka,Faridpur,Sadarpur,Char Nasirpur,0,0,0,0,0,0,0,0,0
Dhaka,Faridpur,Sadarpur,Narikelbaria,0,0,0,0,0,0,0,0,0
Dhaka,Faridpur,Sadarpur,###,10,5,5,3,2,0,5,0,0
Dhaka,Faridpur,Faridpur Sadar,Krishnanagar,10,9,1,0,1,0,9,0,0
Dhaka,Faridpur,Faridpur Sadar,Faridpur Paurashava,14,6,8,0,8,0,4,1,1
Dhaka,Faridpur,Faridpur Sadar,Greda,10,6,4,2,2,0,3,3,0
Dhaka,Faridpur,Faridpur Sadar,Kaijuri,11,11,0,0,0,0,3,6,2
Dhaka,Faridpur,Faridpur Sadar,Uttar Channel,2,2,0,0,0,0,2,0,0
Dhaka,Faridpur,Faridpur Sadar,Majchar,6,6,0,0,0,1,5,0,0
Dhaka,Faridpur,Faridpur Sadar,Kanaipur,6,6,0,0,0,0,5,1,0
Dhaka,Faridpur,Faridpur Sadar,Aliabad,7,6,1,0,1,0,3,3,0
Dhaka,Faridpur,Faridpur Sadar,Ishan Gopalpur,5,5,0,0,0,0,5,0,0
Dhaka,Faridpur,Faridpur Sadar,Char Madhabdia,4,4,0,0,0,0,4,0,0
Dhaka,Faridpur,Faridpur Sadar,Decreerchar,5,5,0,0,0,2,3,0,0
Dhaka,Faridpur,Faridpur Sadar,Ambikapur,2,2,0,0,0,0,2,0,0
Dhaka,Faridpur,Faridpur Sadar,###,82,68,14,2,12,3,48,14,3
Dhaka,Faridpur,Boalmari,Moyna,1,1,0,0,0,0,0,1,0
Dhaka,Faridpur,Boalmari,Satair,1,1,0,0,0,0,1,0,0
Dhaka,Faridpur,Boalmari,Boalmari Paurashava,1,1,0,0,0,0,0,1,0
Dhaka,Faridpur,Boalmari,Chandpur,1,1,0,0,0,0,1,0,0
Dhaka,Faridpur,Boalmari,Shekhar,2,2,0,0,0,0,2,0,0
Dhaka,Faridpur,Boalmari,Gunbaha,1,1,0,0,0,0,0,1,0
Dhaka,Faridpur,Boalmari,Ghoshpur,1,1,0,0,0,0,0,1,0
Dhaka,Faridpur,Boalmari,Parameshwardi,1,1,0,0,0,0,1,0,0
Dhaka,Faridpur,Boalmari,Dadpur,1,1,0,0,0,0,1,0,0
Dhaka,Faridpur,Boalmari,Rupapat,1,1,0,0,0,0,1,0,0
Dhaka,Faridpur,Boalmari,Boalmari,0,0,0,0,0,0,0,0,0
Dhaka,Faridpur,Boalmari,Chatul,0,0,0,0,0,0,0,0,0
Dhaka,Faridpur,Boalmari,###,11,11,0,0,0,0,7,4,0
Dhaka,Faridpur,Char Bhadrasan,Char Bhadrasan,1,1,0,0,0,0,1,0,0
Dhaka,Faridpur,Char Bhadrasan,Char Harirampur,1,1,0,0,0,0,1,0,0
Dhaka,Faridpur,Char Bhadrasan,Gazirtek,2,2,0,0,0,0,2,0,0
Dhaka,Faridpur,Char Bhadrasan,Char Jhaukanda,0,0,0,0,0,0,0,0,0
Dhaka,Faridpur,Char Bhadrasan,###,4,4,0,0,0,0,4,0,0
Dhaka,Faridpur,Alfadanga,Bana,1,1,0,0,0,0,0,1,0
Dhaka,Faridpur,Alfadanga,Tagarbanda,2,1,1,0,1,0,1,0,0
Dhaka,Faridpur,Alfadanga,Buraich,3,2,1,0,1,0,1,1,0
Dhaka,Faridpur,Alfadanga,Alfadanga,1,1,0,0,0,0,0,1,0
Dhaka,Faridpur,Alfadanga,Gopalpur,1,0,1,0,1,0,0,0,0
Dhaka,Faridpur,Alfadanga,Panchuria,0,0,0,0,0,0,0,0,0
Dhaka,Faridpur,Alfadanga,###,8,5,3,0,3,0,2,3,0
Dhaka,Faridpur,Bhanga,Algi,1,1,0,0,0,0,1,0,0
Dhaka,Faridpur,Bhanga,Manikdaha,1,1,0,0,0,0,1,0,0
Dhaka,Faridpur,Bhanga,Bhanga Paurashava,2,2,0,0,0,0,1,0,1
Dhaka,Faridpur,Bhanga,Kaolibera,1,1,0,0,0,0,1,0,0
Dhaka,Faridpur,Bhanga,Chandra,1,1,0,0,0,0,1,0,0
Dhaka,Faridpur,Bhanga,Gharua,1,1,0,0,0,0,1,0,0
Dhaka,Faridpur,Bhanga,Azimnagar,0,0,0,0,0,0,0,0,0
Dhaka,Faridpur,Bhanga,Chumordi,0,0,0,0,0,0,0,0,0
Dhaka,Faridpur,Bhanga,Hamirdi,0,0,0,0,0,0,0,0,0
Dhaka,Faridpur,Bhanga,Kalamridha,0,0,0,0,0,0,0,0,0
Dhaka,Faridpur,Bhanga,Nasirabad,0,0,0,0,0,0,0,0,0
Dhaka,Faridpur,Bhanga,Nurullaganj,0,0,0,0,0,0,0,0,0
Dhaka,Faridpur,Bhanga,Tuzarpur,0,0,0,0,0,0,0,0,0
Dhaka,Faridpur,Bhanga,###,7,7,0,0,0,0,6,0,1
Dhaka,Faridpur,Saltha,Atghar,0,0,0,0,0,0,0,0,0
Dhaka,Faridpur,Saltha,Ballabhdi,0,0,0,0,0,0,0,0,0
Dhaka,Faridpur,Saltha,Bhawal,0,0,0,0,0,0,0,0,0
Dhaka,Faridpur,Saltha,Gatti,0,0,0,0,0,0,0,0,0
Dhaka,Faridpur,Saltha,Jadunandi,0,0,0,0,0,0,0,0,0
Dhaka,Faridpur,Saltha,Majhardia,0,0,0,0,0,0,0,0,0
Dhaka,Faridpur,Saltha,Ramkantapur,0,0,0,0,0,0,0,0,0
Dhaka,Faridpur,Saltha,Sonapur,0,0,0,0,0,0,0,0,0
Dhaka,Faridpur,Saltha,###,0,0,0,0,0,0,0,0,0
Dhaka,Faridpur,###,###,144,117,27,5,22,4,82,25,6
Dhaka,Kishoreganj,Itna,Joy Siddhi,4,0,4,0,4,0,0,0,0
Dhaka,Kishoreganj,Itna,Elongjuri,1,1,0,0,0,0,0,0,1
Dhaka,Kishoreganj,Itna,Baribari,1,1,0,0,0,0,0,0,1
Dhaka,Kishoreganj,Itna,Dhanpur,1,1,0,0,0,0,0,0,1
Dhaka,Kishoreganj,Itna,Raituti,1,1,0,0,0,0,0,0,1
Dhaka,Kishoreganj,Itna,Itna,1,1,0,0,0,0,0,0,1
Dhaka,Kishoreganj,Itna,Badla,1,1,0,0,0,0,0,0,1
Dhaka,Kishoreganj,Itna,Chauganga,0,0,0,0,0,0,0,0,0
Dhaka,Kishoreganj,Itna,Mriga,0,0,0,0,0,0,0,0,0
Dhaka,Kishoreganj,Itna,###,10,6,4,0,4,0,0,0,6
Dhaka,Kishoreganj,Hossainpur,Araibaria,3,1,2,0,2,0,0,1,0
Dhaka,Kishoreganj,Hossainpur,Sahedal,2,2,0,0,0,1,0,0,1
Dhaka,Kishoreganj,Hossainpur,Jinari,1,1,0,0,0,0,0,0,1
Dhaka,Kishoreganj,Hossainpur,Pumdi,1,1,0,0,0,0,0,0,1
Dhaka,Kishoreganj,Hossainpur,Sidhla,1,1,0,0,0,0,0,0,1
Dhaka,Kishoreganj,Hossainpur,Gobindapur,2,2,0,0,0,0,1,0,1
Dhaka,Kishoreganj,Hossainpur,Hossainpur Paurashava,0,0,0,0,0,0,0,0,0
Dhaka,Kishoreganj,Hossainpur,###,10,8,2,0,2,1,1,1,5
Dhaka,Kishoreganj,Bajitpur,Dighirpar,3,3,0,0,0,0,1,0,2
Dhaka,Kishoreganj,Bajitpur,Gazir Char,1,1,0,0,0,0,0,0,1
Dhaka,Kishoreganj,Bajitpur,Sarar Char,2,2,0,0,0,0,1,0,1
Dhaka,Kishoreganj,Bajitpur,Bajitpur Paurashava,3,2,1,1,0,0,2,0,0
Dhaka,Kishoreganj,Bajitpur,Hilachia,1,1,0,0,0,0,0,0,1
Dhaka,Kishoreganj,Bajitpur,Pirijpur,1,1,0,0,0,0,0,0,1
Dhaka,Kishoreganj,Bajitpur,Halimpur,1,1,0,0,0,0,0,0,1
Dhaka,Kishoreganj,Bajitpur,Baliardi,0,0,0,0,0,0,0,0,0
Dhaka,Kishoreganj,Bajitpur,Dilalpur,0,0,0,0,0,0,0,0,0
Dhaka,Kishoreganj,Bajitpur,Humaipur,0,0,0,0,0,0,0,0,0
Dhaka,Kishoreganj,Bajitpur,Kailag,0,0,0,0,0,0,0,0,0
Dhaka,Kishoreganj,Bajitpur,Maij Char,0,0,0,0,0,0,0,0,0
Dhaka,Kishoreganj,Bajitpur,###,12,11,1,1,0,0,4,0,7
Dhaka,Kishoreganj,Kishoreganj Sadar,Maria,1,1,0,0,0,0,0,0,1
Dhaka,Kishoreganj,Kishoreganj Sadar,Korsha Kariail,1,1,0,0,0,0,0,0,1
Dhaka,Kishoreganj,Kishoreganj Sadar,Binnati,1,1,0,0,0,0,0,1,0
Dhaka,Kishoreganj,Kishoreganj Sadar,Baulai,2,2,0,0,0,0,1,0,1
Dhaka,Kishoreganj,Kishoreganj Sadar,Latibabad,1,1,0,0,0,0,0,0,1
Dhaka,Kishoreganj,Kishoreganj Sadar,Kishoreganj Paurashava,3,3,0,0,0,0,2,0,1
Dhaka,Kishoreganj,Kishoreganj Sadar,Mahinanda,4,3,1,1,0,0,2,0,1
Dhaka,Kishoreganj,Kishoreganj Sadar,Jasodal,1,1,0,0,0,0,1,0,0
Dhaka,Kishoreganj,Kishoreganj Sadar,Dana Patali,1,1,0,0,0,0,0,1,0
Dhaka,Kishoreganj,Kishoreganj Sadar,Chauddasata,0,0,0,0,0,0,0,0,0
Dhaka,Kishoreganj,Kishoreganj Sadar,Maij Khapan,0,0,0,0,0,0,0,0,0
Dhaka,Kishoreganj,Kishoreganj Sadar,Rashidabad,0,0,0,0,0,0,0,0,0
Dhaka,Kishoreganj,Kishoreganj Sadar,###,15,14,1,1,0,0,6,2,6
Dhaka,Kishoreganj,Pakundia,Patuabhanga,1,1,0,0,0,0,0,0,1
Dhaka,Kishoreganj,Pakundia,Barudia,1,1,0,0,0,0,0,0,1
Dhaka,Kishoreganj,Pakundia,Jangalia,2,2,0,0,0,0,0,1,1
Dhaka,Kishoreganj,Pakundia,Pakundia Paurashava,3,2,1,1,0,1,0,1,0
Dhaka,Kishoreganj,Pakundia,Egarasindur,1,1,0,0,0,0,0,1,0
Dhaka,Kishoreganj,Pakundia,Chandi Pasha,1,0,1,1,0,0,0,0,0
Dhaka,Kishoreganj,Pakundia,Narandi,1,1,0,0,0,1,0,0,0
Dhaka,Kishoreganj,Pakundia,Char Faradi,0,0,0,0,0,0,0,0,0
Dhaka,Kishoreganj,Pakundia,Hosendi,0,0,0,0,0,0,0,0,0
Dhaka,Kishoreganj,Pakundia,Pakundia,0,0,0,0,0,0,0,0,0
Dhaka,Kishoreganj,Pakundia,Sukhia,0,0,0,0,0,0,0,0,0
Dhaka,Kishoreganj,Pakundia,###,10,8,2,2,0,2,0,3,3
Dhaka,Kishoreganj,Austagram,Bangal Para,1,1,0,0,0,0,0,0,1
Dhaka,Kishoreganj,Austagram,Deoghar,1,1,0,0,0,0,0,0,1
Dhaka,Kishoreganj,Austagram,Austagram,2,2,0,0,0,0,1,0,1
Dhaka,Kishoreganj,Austagram,Kastail,1,1,0,0,0,0,0,0,1
Dhaka,Kishoreganj,Austagram,Adampur,0,0,0,0,0,0,0,0,0
Dhaka,Kishoreganj,Austagram,Kalma,0,0,0,0,0,0,0,0,0
Dhaka,Kishoreganj,Austagram,Khayerpur Abdullahpur,0,0,0,0,0,0,0,0,0
Dhaka,Kishoreganj,Austagram,Purba Austagram,0,0,0,0,0,0,0,0,0
Dhaka,Kishoreganj,Austagram,###,5,5,0,0,0,0,1,0,4
Dhaka,Kishoreganj,Katiadi,Banagram,1,1,0,0,0,0,0,1,0
Dhaka,Kishoreganj,Katiadi,Achmita,1,1,0,0,0,0,0,1,0
Dhaka,Kishoreganj,Katiadi,Mumurdia,1,1,0,0,0,0,0,1,0
Dhaka,Kishoreganj,Katiadi,Katiadi Paurashava,2,1,1,1,0,0,1,0,0
Dhaka,Kishoreganj,Katiadi,Shahasram Dhuldia,1,1,0,0,0,0,0,0,1
Dhaka,Kishoreganj,Katiadi,Kargaon,1,1,0,0,0,0,0,1,0
Dhaka,Kishoreganj,Katiadi,Chandpur,0,0,0,0,0,0,0,0,0
Dhaka,Kishoreganj,Katiadi,Jalalpur,0,0,0,0,0,0,0,0,0
Dhaka,Kishoreganj,Katiadi,Katiadi,0,0,0,0,0,0,0,0,0
Dhaka,Kishoreganj,Katiadi,Lohajuri,0,0,0,0,0,0,0,0,0
Dhaka,Kishoreganj,Katiadi,Masua,0,0,0,0,0,0,0,0,0
Dhaka,Kishoreganj,Katiadi,###,7,6,1,1,0,0,1,4,1
Dhaka,Kishoreganj,Mithamain,Keorjori,1,1,0,0,0,0,0,0,1
Dhaka,Kishoreganj,Mithamain,Ghagra,1,1,0,0,0,0,0,0,1
Dhaka,Kishoreganj,Mithamain,Gopedighi,1,1,0,0,0,0,0,0,1
Dhaka,Kishoreganj,Mithamain,Mithamain,1,1,0,0,0,0,0,0,1
Dhaka,Kishoreganj,Mithamain,Dhaki,1,1,0,0,0,0,0,0,1
Dhaka,Kishoreganj,Mithamain,Bairati,0,0,0,0,0,0,0,0,0
Dhaka,Kishoreganj,Mithamain,Khatkhal,0,0,0,0,0,0,0,0,0
Dhaka,Kishoreganj,Mithamain,###,5,5,0,0,0,0,0,0,5
Dhaka,Kishoreganj,Bhairab,Sreenagar,2,2,0,0,0,0,0,0,2
Dhaka,Kishoreganj,Bhairab,Kalika Prasad,2,2,0,0,0,0,1,0,1
Dhaka,Kishoreganj,Bhairab,Shibpur,1,1,0,0,0,0,0,0,1
Dhaka,Kishoreganj,Bhairab,Bhairab Paurashava,3,2,1,1,0,0,0,2,0
Dhaka,Kishoreganj,Bhairab,Gazaria,2,2,0,0,0,0,0,1,1
Dhaka,Kishoreganj,Bhairab,Aganagar,0,0,0,0,0,0,0,0,0
Dhaka,Kishoreganj,Bhairab,Sadakpur,0,0,0,0,0,0,0,0,0
Dhaka,Kishoreganj,Bhairab,Shimulkandi,0,0,0,0,0,0,0,0,0
Dhaka,Kishoreganj,Bhairab,###,10,9,1,1,0,0,1,3,5
Dhaka,Kishoreganj,Tarail,Talganga,1,1,0,0,0,0,0,0,1
Dhaka,Kishoreganj,Tarail,Tarail Sachail,2,1,1,1,0,0,0,1,0
Dhaka,Kishoreganj,Tarail,Dhala,2,2,0,0,0,0,0,1,1
Dhaka,Kishoreganj,Tarail,Rauti,1,1,0,0,0,0,0,0,1
Dhaka,Kishoreganj,Tarail,Jawar,1,1,0,0,0,0,1,0,0
Dhaka,Kishoreganj,Tarail,Damiha,0,0,0,0,0,0,0,0,0
Dhaka,Kishoreganj,Tarail,Digdair,0,0,0,0,0,0,0,0,0
Dhaka,Kishoreganj,Tarail,###,7,6,1,1,0,0,1,2,3
Dhaka,Kishoreganj,Kuliar Char,Osmanpur,2,2,0,0,0,0,0,1,1
Dhaka,Kishoreganj,Kuliar Char,Kuliar Char Paurashava,1,0,1,1,0,0,0,0,0
Dhaka,Kishoreganj,Kuliar Char,Ramdi,1,1,0,0,0,0,0,0,1
Dhaka,Kishoreganj,Kuliar Char,Gobaria Abdullahpur,1,1,0,0,0,0,0,0,1
Dhaka,Kishoreganj,Kuliar Char,Salua,1,1,0,0,0,0,0,0,1
Dhaka,Kishoreganj,Kuliar Char,Chhaysuti,1,1,0,0,0,0,0,0,1
Dhaka,Kishoreganj,Kuliar Char,Faridpur,0,0,0,0,0,0,0,0,0
Dhaka,Kishoreganj,Kuliar Char,###,7,6,1,1,0,0,0,1,5
Dhaka,Kishoreganj,Nikli,Gurai,1,1,0,0,0,0,0,0,1
Dhaka,Kishoreganj,Nikli,Singpur,1,1,0,0,0,0,0,0,1
Dhaka,Kishoreganj,Nikli,Nikli,1,1,0,0,0,0,0,0,1
Dhaka,Kishoreganj,Nikli,Karpasha,1,1,0,0,0,0,0,0,1
Dhaka,Kishoreganj,Nikli,Jaraitala,1,1,0,0,0,0,0,0,1
Dhaka,Kishoreganj,Nikli,Chhatir Char,0,0,0,0,0,0,0,0,0
Dhaka,Kishoreganj,Nikli,Dampara,0,0,0,0,0,0,0,0,0
Dhaka,Kishoreganj,Nikli,###,5,5,0,0,0,0,0,0,5
Dhaka,Kishoreganj,Karimganj,Jafarabad,2,1,1,1,0,0,0,0,1
Dhaka,Kishoreganj,Karimganj,Sutar Para,1,1,0,0,0,0,0,0,1
Dhaka,Kishoreganj,Karimganj,Gundhar,1,1,0,0,0,0,0,0,1
Dhaka,Kishoreganj,Karimganj,Niamatpur,1,1,0,0,0,0,0,0,1
Dhaka,Kishoreganj,Karimganj,Joyka,1,1,0,0,0,0,0,0,1
Dhaka,Kishoreganj,Karimganj,Karimganj Paurashava,3,2,1,1,0,1,0,0,1
Dhaka,Kishoreganj,Karimganj,Baragharia,0,0,0,0,0,0,0,0,0
Dhaka,Kishoreganj,Karimganj,Dehunda,0,0,0,0,0,0,0,0,0
Dhaka,Kishoreganj,Karimganj,Gujadia,0,0,0,0,0,0,0,0,0
Dhaka,Kishoreganj,Karimganj,Kadir Jangal,0,0,0,0,0,0,0,0,0
Dhaka,Kishoreganj,Karimganj,Kiratan,0,0,0,0,0,0,0,0,0
Dhaka,Kishoreganj,Karimganj,Noabad,0,0,0,0,0,0,0,0,0
Dhaka,Kishoreganj,Karimganj,###,9,7,2,2,0,1,0,0,6
Dhaka,Kishoreganj,###,###,112,96,16,10,6,4,15,16,61
Dhaka,Shariatpur,Naria,Fateh Jangapur,2,1,1,0,1,0,1,0,0
Dhaka,Shariatpur,Naria,Bijhari,2,1,1,0,1,0,1,0,0
Dhaka,Shariatpur,Naria,Naria Paurashava,5,1,4,0,4,0,1,0,0
Dhaka,Shariatpur,Naria,Dinga Manik,1,1,0,0,0,0,1,0,0
Dhaka,Shariatpur,Naria,Kedarpur,1,1,0,0,0,0,1,0,0
Dhaka,Shariatpur,Naria,Bhumkhara,1,1,0,0,0,0,1,0,0
Dhaka,Shariatpur,Naria,Bhojeshwar,0,0,0,0,0,0,0,0,0
Dhaka,Shariatpur,Naria,Chamta,0,0,0,0,0,0,0,0,0
Dhaka,Shariatpur,Naria,Char Atra,0,0,0,0,0,0,0,0,0
Dhaka,Shariatpur,Naria,Gharisar,0,0,0,0,0,0,0,0,0
Dhaka,Shariatpur,Naria,Japsa,0,0,0,0,0,0,0,0,0
Dhaka,Shariatpur,Naria,Muktarer Char,0,0,0,0,0,0,0,0,0
Dhaka,Shariatpur,Naria,Nasasan,0,0,0,0,0,0,0,0,0
Dhaka,Shariatpur,Naria,Noapara,0,0,0,0,0,0,0,0,0
Dhaka,Shariatpur,Naria,Rajnagar,0,0,0,0,0,0,0,0,0
Dhaka,Shariatpur,Naria,###,12,6,6,0,6,0,6,0,0
Dhaka,Shariatpur,Shariatpur Sadar,Binodpur,1,0,1,0,1,0,0,0,0
Dhaka,Shariatpur,Shariatpur Sadar,Chitalia,4,2,2,0,2,1,1,0,0
Dhaka,Shariatpur,Shariatpur Sadar,Tulasar,2,0,2,0,2,0,0,0,0
Dhaka,Shariatpur,Shariatpur Sadar,Shariatpur Paurashava,4,2,2,0,2,0,2,0,0
Dhaka,Shariatpur,Shariatpur Sadar,Domsar,1,1,0,0,0,0,1,0,0
Dhaka,Shariatpur,Shariatpur Sadar,Angaria,1,1,0,0,0,1,0,0,0
Dhaka,Shariatpur,Shariatpur Sadar,Palong,1,1,0,0,0,0,0,1,0
Dhaka,Shariatpur,Shariatpur Sadar,Rudrakar,1,1,0,0,0,0,1,0,0
Dhaka,Shariatpur,Shariatpur Sadar,Chandrapur,0,0,0,0,0,0,0,0,0
Dhaka,Shariatpur,Shariatpur Sadar,Chikandi,0,0,0,0,0,0,0,0,0
Dhaka,Shariatpur,Shariatpur Sadar,Mohammadpur,0,0,0,0,0,0,0,0,0
Dhaka,Shariatpur,Shariatpur Sadar,Shaul Para,0,0,0,0,0,0,0,0,0
Dhaka,Shariatpur,Shariatpur Sadar,###,15,8,7,0,7,2,5,1,0
Dhaka,Shariatpur,Zanjira,Bilaspur,2,1,1,0,1,1,0,0,0
Dhaka,Shariatpur,Zanjira,Naodoba,1,1,0,0,0,0,1,0,0
Dhaka,Shariatpur,Zanjira,Zanjira Paurashava,2,2,0,0,0,1,1,0,0
Dhaka,Shariatpur,Zanjira,Barakandi,1,1,0,0,0,0,1,0,0
Dhaka,Shariatpur,Zanjira,Mulna,1,1,0,0,0,0,1,0,0
Dhaka,Shariatpur,Zanjira,Bara Krishnagar,1,1,0,0,0,0,1,0,0
Dhaka,Shariatpur,Zanjira,Kunder Char,1,1,0,0,0,0,1,0,0
Dhaka,Shariatpur,Zanjira,Bara Gopalpur,0,0,0,0,0,0,0,0,0
Dhaka,Shariatpur,Zanjira,Joynagar,0,0,0,0,0,0,0,0,0
Dhaka,Shariatpur,Zanjira,Paler Char,0,0,0,0,0,0,0,0,0
Dhaka,Shariatpur,Zanjira,Purba Naodoba,0,0,0,0,0,0,0,0,0
Dhaka,Shariatpur,Zanjira,Sener Char,0,0,0,0,0,0,0,0,0
Dhaka,Shariatpur,Zanjira,Zanjira,0,0,0,0,0,0,0,0,0
Dhaka,Shariatpur,Zanjira,###,9,8,1,0,1,2,6,0,0
Dhaka,Shariatpur,Bhedarganj,Char Census,1,0,1,0,1,0,0,0,0
Dhaka,Shariatpur,Bhedarganj,Bhedarganj Paurashava,3,1,2,0,2,0,1,0,0
Dhaka,Shariatpur,Bhedarganj,Sakhipur,1,1,0,0,0,0,1,0,0
Dhaka,Shariatpur,Bhedarganj,Rambhadrapur,1,1,0,0,0,0,1,0,0
Dhaka,Shariatpur,Bhedarganj,Digar Mahishkhali,1,1,0,0,0,0,1,0,0
Dhaka,Shariatpur,Bhedarganj,Narayanpur,1,1,0,0,0,0,0,1,0
Dhaka,Shariatpur,Bhedarganj,Mahisar,3,1,2,0,2,0,1,0,0
Dhaka,Shariatpur,Bhedarganj,Char Kumaria,1,1,0,0,0,0,1,0,0
Dhaka,Shariatpur,Bhedarganj,Char Bhaga,1,1,0,0,0,0,1,0,0
Dhaka,Shariatpur,Bhedarganj,Arshi Nagar,0,0,0,0,0,0,0,0,0
Dhaka,Shariatpur,Bhedarganj,Chhaygaon,0,0,0,0,0,0,0,0,0
Dhaka,Shariatpur,Bhedarganj,Dhakhin Tarabunia,0,0,0,0,0,0,0,0,0
Dhaka,Shariatpur,Bhedarganj,Kachikata,0,0,0,0,0,0,0,0,0
Dhaka,Shariatpur,Bhedarganj,Tarabunia,0,0,0,0,0,0,0,0,0
Dhaka,Shariatpur,Bhedarganj,###,13,8,5,0,5,0,7,1,0
Dhaka,Shariatpur,Damudya,Purba Damudya,1,0,1,0,1,0,0,0,0
Dhaka,Shariatpur,Damudya,Damudya Paurashava,3,1,2,0,2,0,0,1,0
Dhaka,Shariatpur,Damudya,Darul Aman,5,1,4,0,4,0,1,0,0
Dhaka,Shariatpur,Damudya,Kaneshwar,1,1,0,0,0,0,0,1,0
Dhaka,Shariatpur,Damudya,Islam Pur,1,1,0,0,0,0,1,0,0
Dhaka,Shariatpur,Damudya,Sidulkura,1,1,0,0,0,0,1,0,0
Dhaka,Shariatpur,Damudya,Dhankati,0,0,0,0,0,0,0,0,0
Dhaka,Shariatpur,Damudya,Sidya,0,0,0,0,0,0,0,0,0
Dhaka,Shariatpur,Damudya,###,12,5,7,0,7,0,3,2,0
Dhaka,Shariatpur,Gosairhat,Idilpur,5,1,4,0,4,0,1,0,0
Dhaka,Shariatpur,Gosairhat,Gosairhat,2,2,0,0,0,0,2,0,0
Dhaka,Shariatpur,Gosairhat,Kodalpur,1,1,0,0,0,0,1,0,0
Dhaka,Shariatpur,Gosairhat,Nager Para,2,1,1,0,1,0,1,0,0
Dhaka,Shariatpur,Gosairhat,Nalmuri,1,1,0,0,0,0,1,0,0
Dhaka,Shariatpur,Gosairhat,Gariber Char,0,0,0,0,0,0,0,0,0
Dhaka,Shariatpur,Gosairhat,Kuchaipatti,0,0,0,0,0,0,0,0,0
Dhaka,Shariatpur,Gosairhat,Samantasar,0,0,0,0,0,0,0,0,0
Dhaka,Shariatpur,Gosairhat,###,11,6,5,0,5,0,6,0,0
Dhaka,Shariatpur,###,###,72,41,31,0,31,4,33,4,0
Dhaka,Rajbari,Balia Kandi,Jamalpur,2,0,2,0,2,0,0,0,0
Dhaka,Rajbari,Balia Kandi,Narua,1,1,0,0,0,0,0,1,0
Dhaka,Rajbari,Balia Kandi,Jangal,1,1,0,0,0,0,0,1,0
Dhaka,Rajbari,Balia Kandi,Baharpur,2,2,0,0,0,0,1,1,0
Dhaka,Rajbari,Balia Kandi,Islampur,1,1,0,0,0,0,0,1,0
Dhaka,Rajbari,Balia Kandi,Nawabpur,1,1,0,0,0,0,0,1,0
Dhaka,Rajbari,Balia Kandi,Baliakandi,0,0,0,0,0,0,0,0,0
Dhaka,Rajbari,Balia Kandi,###,8,6,2,0,2,0,1,5,0
Dhaka,Rajbari,Rajbari Sadar,Banibaha,1,1,0,0,0,0,0,1,0
Dhaka,Rajbari,Rajbari Sadar,Panchuria,1,1,0,0,0,0,1,0,0
Dhaka,Rajbari,Rajbari Sadar,Basantapur,1,1,0,0,0,0,1,0,0
Dhaka,Rajbari,Rajbari Sadar,Shahid Wahabpur,1,1,0,0,0,0,1,0,0
Dhaka,Rajbari,Rajbari Sadar,Mizanpur,1,1,0,0,0,0,0,1,0
Dhaka,Rajbari,Rajbari Sadar,Barat,1,1,0,0,0,0,1,0,0
Dhaka,Rajbari,Rajbari Sadar,Khankhanapur,1,1,0,0,0,0,1,0,0
Dhaka,Rajbari,Rajbari Sadar,Dadshi,1,1,0,0,0,0,1,0,0
Dhaka,Rajbari,Rajbari Sadar,Rajbari Paurashava,1,1,0,0,0,0,1,0,0
Dhaka,Rajbari,Rajbari Sadar,Alipur,0,0,0,0,0,0,0,0,0
Dhaka,Rajbari,Rajbari Sadar,Chandani,0,0,0,0,0,0,0,0,0
Dhaka,Rajbari,Rajbari Sadar,Khanganj,0,0,0,0,0,0,0,0,0
Dhaka,Rajbari,Rajbari Sadar,Mulghar,0,0,0,0,0,0,0,0,0
Dhaka,Rajbari,Rajbari Sadar,Ramkantapur,0,0,0,0,0,0,0,0,0
Dhaka,Rajbari,Rajbari Sadar,Sultanpur,0,0,0,0,0,0,0,0,0
Dhaka,Rajbari,Rajbari Sadar,###,9,9,0,0,0,0,7,2,0
Dhaka,Rajbari,Pangsha,Maurat,1,1,0,0,0,0,0,1,0
Dhaka,Rajbari,Pangsha,Kalimahar,2,2,0,0,0,0,2,0,0
Dhaka,Rajbari,Pangsha,Patta,1,1,0,0,0,0,1,0,0
Dhaka,Rajbari,Pangsha,Habaspur,1,1,0,0,0,0,1,0,0
Dhaka,Rajbari,Pangsha,Pangsha Paurashava,1,1,0,0,0,0,0,1,0
Dhaka,Rajbari,Pangsha,Machh Para,1,1,0,0,0,0,1,0,0
Dhaka,Rajbari,Pangsha,Bahadurpur,1,1,0,0,0,0,1,0,0
Dhaka,Rajbari,Pangsha,Babupara,0,0,0,0,0,0,0,0,0
Dhaka,Rajbari,Pangsha,Jashai,0,0,0,0,0,0,0,0,0
Dhaka,Rajbari,Pangsha,Kasba Majhail,0,0,0,0,0,0,0,0,0
Dhaka,Rajbari,Pangsha,Sarisha,0,0,0,0,0,0,0,0,0
Dhaka,Rajbari,Pangsha,###,8,8,0,0,0,0,6,2,0
Dhaka,Rajbari,Goalandaghat,Daulatdia,2,2,0,0,0,0,2,0,0
Dhaka,Rajbari,Goalandaghat,Ujan Char,3,3,0,0,0,0,3,0,0
Dhaka,Rajbari,Goalandaghat,Debagram,1,1,0,0,0,0,1,0,0
Dhaka,Rajbari,Goalandaghat,Chhota Bhakla,0,0,0,0,0,0,0,0,0
Dhaka,Rajbari,Goalandaghat,Goalandaghat Paurashava,0,0,0,0,0,0,0,0,0
Dhaka,Rajbari,Goalandaghat,###,6,6,0,0,0,0,6,0,0
Dhaka,Rajbari,Kalukhali,Mrigi,1,1,0,0,0,0,1,0,0
Dhaka,Rajbari,Kalukhali,Majhbari,1,1,0,0,0,0,1,0,0
Dhaka,Rajbari,Kalukhali,Ratandia,1,1,0,0,0,0,1,0,0
Dhaka,Rajbari,Kalukhali,Boalia,0,0,0,0,0,0,0,0,0
Dhaka,Rajbari,Kalukhali,Kalikapur,0,0,0,0,0,0,0,0,0
Dhaka,Rajbari,Kalukhali,Madapur,0,0,0,0,0,0,0,0,0
Dhaka,Rajbari,Kalukhali,Saorail,0,0,0,0,0,0,0,0,0
Dhaka,Rajbari,Kalukhali,###,3,3,0,0,0,0,3,0,0
Dhaka,Rajbari,###,###,34,32,2,0,2,0,23,9,0
Dhaka,Gazipur,Gazipur Sadar,Tongi Paurashava,3,1,2,0,2,0,1,0,0
Dhaka,Gazipur,Gazipur Sadar,Gazipur Paurashava,2,1,1,1,0,0,0,1,0
Dhaka,Gazipur,Gazipur Sadar,Basan,1,1,0,0,0,0,0,0,1
Dhaka,Gazipur,Gazipur Sadar,Baria,1,1,0,0,0,0,0,1,0
Dhaka,Gazipur,Gazipur Sadar,Kayaltia,1,1,0,0,0,0,0,1,0
Dhaka,Gazipur,Gazipur Sadar,Konabari,1,1,0,0,0,0,0,1,0
Dhaka,Gazipur,Gazipur Sadar,Mirzapur,1,1,0,0,0,0,0,1,0
Dhaka,Gazipur,Gazipur Sadar,Gachha,1,1,0,0,0,0,0,0,1
Dhaka,Gazipur,Gazipur Sadar,Pubail,1,1,0,0,0,0,0,0,1
Dhaka,Gazipur,Gazipur Sadar,Kashimpur,0,0,0,0,0,0,0,0,0
Dhaka,Gazipur,Gazipur Sadar,###,12,9,3,1,2,0,1,5,3
Dhaka,Gazipur,Kaliganj,Baktarpur,2,1,1,1,0,0,1,0,0
Dhaka,Gazipur,Kaliganj,Tumulia,1,1,0,0,0,0,0,1,0
Dhaka,Gazipur,Kaliganj,Kaliganj,3,3,0,0,0,0,1,2,0
Dhaka,Gazipur,Kaliganj,Jangalia,1,1,0,0,0,0,0,1,0
Dhaka,Gazipur,Kaliganj,Nagari,1,1,0,0,0,0,1,0,0
Dhaka,Gazipur,Kaliganj,Moktarpur,1,1,0,0,0,0,0,1,0
Dhaka,Gazipur,Kaliganj,Jamalpur,1,1,0,0,0,0,0,1,0
Dhaka,Gazipur,Kaliganj,Bahadursadi,0,0,0,0,0,0,0,0,0
Dhaka,Gazipur,Kaliganj,###,10,9,1,1,0,0,3,6,0
Dhaka,Gazipur,Sreepur,Prahladpur,1,1,0,0,0,0,0,0,1
Dhaka,Gazipur,Sreepur,Maona,2,2,0,0,0,0,0,2,0
Dhaka,Gazipur,Sreepur,Sreepur Paurashava,1,1,0,0,0,0,0,1,0
Dhaka,Gazipur,Sreepur,Rajabari,1,1,0,0,0,0,0,1,0
Dhaka,Gazipur,Sreepur,Gazipur,2,2,0,0,0,0,0,2,0
Dhaka,Gazipur,Sreepur,Barmi,1,1,0,0,0,0,0,1,0
Dhaka,Gazipur,Sreepur,Gosinga,1,1,0,0,0,0,0,1,0
Dhaka,Gazipur,Sreepur,Telihati,1,1,0,0,0,0,1,0,0
Dhaka,Gazipur,Sreepur,Kaoraid,0,0,0,0,0,0,0,0,0
Dhaka,Gazipur,Sreepur,###,10,10,0,0,0,0,1,8,1
Dhaka,Gazipur,Kapasia,Barishaba,1,1,0,0,0,0,0,1,0
Dhaka,Gazipur,Kapasia,Karihata,2,2,0,0,0,0,0,2,0
Dhaka,Gazipur,Kapasia,Targaon,1,1,0,0,0,0,0,1,0
Dhaka,Gazipur,Kapasia,Kapasia,1,1,0,0,0,0,0,1,0
Dhaka,Gazipur,Kapasia,Rayed,1,1,0,0,0,0,0,1,0
Dhaka,Gazipur,Kapasia,Chandpur,1,1,0,0,0,0,1,0,0
Dhaka,Gazipur,Kapasia,Ghagotia,1,1,0,0,0,0,1,0,0
Dhaka,Gazipur,Kapasia,Durgapur,1,1,0,0,0,0,0,1,0
Dhaka,Gazipur,Kapasia,Sanmania,0,0,0,0,0,0,0,0,0
Dhaka,Gazipur,Kapasia,Singasree,0,0,0,0,0,0,0,0,0
Dhaka,Gazipur,Kapasia,Toke,0,0,0,0,0,0,0,0,0
Dhaka,Gazipur,Kapasia,###,9,9,0,0,0,0,2,7,0
Dhaka,Gazipur,Kaliakair,Kaliakair Paurashava,1,1,0,0,0,0,0,1,0
Dhaka,Gazipur,Kaliakair,Fulbaria,1,1,0,0,0,0,0,1,0
Dhaka,Gazipur,Kaliakair,Mouchak,1,1,0,0,0,0,0,1,0
Dhaka,Gazipur,Kaliakair,Atabaha,1,1,0,0,0,0,0,1,0
Dhaka,Gazipur,Kaliakair,Madhyapara,1,1,0,0,0,0,0,1,0
Dhaka,Gazipur,Kaliakair,Boali,0,0,0,0,0,0,0,0,0
Dhaka,Gazipur,Kaliakair,Chapair,0,0,0,0,0,0,0,0,0
Dhaka,Gazipur,Kaliakair,Dhaljora,0,0,0,0,0,0,0,0,0
Dhaka,Gazipur,Kaliakair,Sreefaltali,0,0,0,0,0,0,0,0,0
Dhaka,Gazipur,Kaliakair,Sutrapur,0,0,0,0,0,0,0,0,0
Dhaka,Gazipur,Kaliakair,###,5,5,0,0,0,0,0,5,0
Dhaka,Gazipur,###,###,46,42,4,2,2,0,7,31,4
Dhaka,Manikganj,Saturia,Fukurhati,1,1,0,0,0,0,1,0,0
Dhaka,Manikganj,Saturia,Baraid,2,2,0,0,0,1,1,0,0
Dhaka,Manikganj,Saturia,Baliati,2,1,1,1,0,0,1,0,0
Dhaka,Manikganj,Saturia,Daragram,1,1,0,0,0,0,1,0,0
Dhaka,Manikganj,Saturia,Dhankora,1,1,0,0,0,0,1,0,0
Dhaka,Manikganj,Saturia,Hargaz,1,1,0,0,0,0,1,0,0
Dhaka,Manikganj,Saturia,Tilli,1,1,0,0,0,0,1,0,0
Dhaka,Manikganj,Saturia,Dighalia,0,0,0,0,0,0,0,0,0
Dhaka,Manikganj,Saturia,Saturia,0,0,0,0,0,0,0,0,0
Dhaka,Manikganj,Saturia,###,9,8,1,1,0,1,7,0,0
Dhaka,Manikganj,Daulatpur,Chak Mirpur,2,2,0,0,0,0,1,0,1
Dhaka,Manikganj,Daulatpur,Dhamsar,1,1,0,0,0,0,1,0,0
Dhaka,Manikganj,Daulatpur,Baghutia,1,1,0,0,0,0,1,0,0
Dhaka,Manikganj,Daulatpur,Khalsi,1,1,0,0,0,0,0,1,0
Dhaka,Manikganj,Daulatpur,Kalia,1,1,0,0,0,0,1,0,0
Dhaka,Manikganj,Daulatpur,Bachamara,0,0,0,0,0,0,0,0,0
Dhaka,Manikganj,Daulatpur,Charkatari,0,0,0,0,0,0,0,0,0
Dhaka,Manikganj,Daulatpur,Jiyanpur,0,0,0,0,0,0,0,0,0
Dhaka,Manikganj,Daulatpur,###,6,6,0,0,0,0,4,1,1
Dhaka,Manikganj,Singair,Jamirta,1,1,0,0,0,0,0,1,0
Dhaka,Manikganj,Singair,Singair Paurashava,1,1,0,0,0,0,1,0,0
Dhaka,Manikganj,Singair,Dhalla,1,1,0,0,0,0,0,1,0
Dhaka,Manikganj,Singair,Saista,1,1,0,0,0,0,1,0,0
Dhaka,Manikganj,Singair,Baldhara,0,0,0,0,0,0,0,0,0
Dhaka,Manikganj,Singair,Boyra,0,0,0,0,0,0,0,0,0
Dhaka,Manikganj,Singair,Chandhar,0,0,0,0,0,0,0,0,0
Dhaka,Manikganj,Singair,Charigram,0,0,0,0,0,0,0,0,0
Dhaka,Manikganj,Singair,Jamsha,0,0,0,0,0,0,0,0,0
Dhaka,Manikganj,Singair,Joy Mantap,0,0,0,0,0,0,0,0,0
Dhaka,Manikganj,Singair,Singair,0,0,0,0,0,0,0,0,0
Dhaka,Manikganj,Singair,Talibpur,0,0,0,0,0,0,0,0,0
Dhaka,Manikganj,Singair,###,4,4,0,0,0,0,2,2,0
Dhaka,Manikganj,Harirampur,Balla,2,2,0,0,0,0,2,0,0
Dhaka,Manikganj,Harirampur,Balara,1,1,0,0,0,0,1,0,0
Dhaka,Manikganj,Harirampur,Gala,1,1,0,0,0,0,1,0,0
Dhaka,Manikganj,Harirampur,Boyra,1,0,1,1,0,0,0,0,0
Dhaka,Manikganj,Harirampur,Chala,1,1,0,0,0,0,1,0,0
Dhaka,Manikganj,Harirampur,Azimnagar,0,0,0,0,0,0,0,0,0
Dhaka,Manikganj,Harirampur,Dhulsunra,0,0,0,0,0,0,0,0,0
Dhaka,Manikganj,Harirampur,Gopinathpur,0,0,0,0,0,0,0,0,0
Dhaka,Manikganj,Harirampur,Harukandi,0,0,0,0,0,0,0,0,0
Dhaka,Manikganj,Harirampur,Kanchanpur,0,0,0,0,0,0,0,0,0
Dhaka,Manikganj,Harirampur,Lesraganj,0,0,0,0,0,0,0,0,0
Dhaka,Manikganj,Harirampur,Ramkrishnapur,0,0,0,0,0,0,0,0,0
Dhaka,Manikganj,Harirampur,Sutalari,0,0,0,0,0,0,0,0,0
Dhaka,Manikganj,Harirampur,###,6,5,1,1,0,0,5,0,0
Dhaka,Manikganj,Manikganj Sadar,Betila Mitara,1,1,0,0,0,0,1,0,0
Dhaka,Manikganj,Manikganj Sadar,Garpara,1,1,0,0,0,1,0,0,0
Dhaka,Manikganj,Manikganj Sadar,Putail,1,1,0,0,0,0,1,0,0
Dhaka,Manikganj,Manikganj Sadar,Krishnapur,2,2,0,0,0,0,2,0,0
Dhaka,Manikganj,Manikganj Sadar,Manikganj Paurashava,2,1,1,1,0,0,1,0,0
Dhaka,Manikganj,Manikganj Sadar,Bhararia,1,1,0,0,0,0,1,0,0
Dhaka,Manikganj,Manikganj Sadar,Atigram,0,0,0,0,0,0,0,0,0
Dhaka,Manikganj,Manikganj Sadar,Dighi,0,0,0,0,0,0,0,0,0
Dhaka,Manikganj,Manikganj Sadar,Hati Para,0,0,0,0,0,0,0,0,0
Dhaka,Manikganj,Manikganj Sadar,Jaigir,0,0,0,0,0,0,0,0,0
Dhaka,Manikganj,Manikganj Sadar,Nabagram,0,0,0,0,0,0,0,0,0
Dhaka,Manikganj,Manikganj Sadar,###,8,7,1,1,0,1,6,0,0
Dhaka,Manikganj,Shibalaya,Mohadebpur,1,1,0,0,0,0,1,0,0
Dhaka,Manikganj,Shibalaya,Teota,1,1,0,0,0,0,1,0,0
Dhaka,Manikganj,Shibalaya,Ulail,2,1,1,1,0,0,0,1,0
Dhaka,Manikganj,Shibalaya,Shibalaya,1,1,0,0,0,0,0,1,0
Dhaka,Manikganj,Shibalaya,Uthali,1,1,0,0,0,0,0,1,0
Dhaka,Manikganj,Shibalaya,Arua,0,0,0,0,0,0,0,0,0
Dhaka,Manikganj,Shibalaya,Shimulia,0,0,0,0,0,0,0,0,0
Dhaka,Manikganj,Shibalaya,###,6,5,1,1,0,0,2,3,0
Dhaka,Manikganj,Ghior,Ghior,2,1,1,1,0,0,1,0,0
Dhaka,Manikganj,Ghior,Nali,1,1,0,0,0,0,1,0,0
Dhaka,Manikganj,Ghior,Baliakhora,2,2,0,0,0,0,1,1,0
Dhaka,Manikganj,Ghior,Baratia,1,1,0,0,0,0,0,1,0
Dhaka,Manikganj,Ghior,Paila,1,1,0,0,0,0,1,0,0
Dhaka,Manikganj,Ghior,Baniajuri,0,0,0,0,0,0,0,0,0
Dhaka,Manikganj,Ghior,Singjuri,0,0,0,0,0,0,0,0,0
Dhaka,Manikganj,Ghior,###,7,6,1,1,0,0,4,2,0
Dhaka,Manikganj,###,###,46,41,5,5,0,2,30,8,1
Dhaka,###,###,###,1349,682,667,30,637,23,383,178,98
Barisal,Barisal,Gaurnadi,Paurashava,12,1,11,0,11,0,1,0,0
Barisal,Barisal,Gaurnadi,Batajore,20,0,20,0,20,0,0,0,0
Barisal,Barisal,Gaurnadi,Chandshi,35,1,34,0,34,0,1,0,0
Barisal,Barisal,Gaurnadi,Khanjapur,14,1,13,0,13,0,0,1,0
Barisal,Barisal,Gaurnadi,Mahilara,22,2,20,0,20,0,2,0,0
Barisal,Barisal,Gaurnadi,Nalchira,27,0,27,0,27,0,0,0,0
Barisal,Barisal,Gaurnadi,Sarikal,24,0,24,0,24,0,0,0,0
Barisal,Barisal,Gaurnadi,Barthi,3,1,2,0,2,0,1,0,0
Barisal,Barisal,Gaurnadi,###,157,6,151,0,151,0,5,1,0
Barisal,Barisal,Barisal Sadar (Kotwali),Char Monai,98,0,98,0,98,0,0,0,0
Barisal,Barisal,Barisal Sadar (Kotwali),Ward No-05,1,0,1,0,1,0,0,0,0
Barisal,Barisal,Barisal Sadar (Kotwali),Char Kowa,87,2,85,0,85,0,2,0,0
Barisal,Barisal,Barisal Sadar (Kotwali),Tungibaria,91,0,91,0,91,0,0,0,0
Barisal,Barisal,Barisal Sadar (Kotwali),Chandpur,86,0,86,0,86,0,0,0,0
Barisal,Barisal,Barisal Sadar (Kotwali),Jagua,53,0,53,0,53,0,0,0,0
Barisal,Barisal,Barisal Sadar (Kotwali),Ward No-26,27,1,26,0,26,0,1,0,0
Barisal,Barisal,Barisal Sadar (Kotwali),Ward No-27,12,0,12,0,12,0,0,0,0
Barisal,Barisal,Barisal Sadar (Kotwali),Roy Pasha Karapur,70,1,69,0,69,0,1,0,0
Barisal,Barisal,Barisal Sadar (Kotwali),Kashipur,73,0,73,0,73,0,0,0,0
Barisal,Barisal,Barisal Sadar (Kotwali),Ward No-03,5,0,5,0,5,0,0,0,0
Barisal,Barisal,Barisal Sadar (Kotwali),Char Baria,57,1,56,0,56,0,1,0,0
Barisal,Barisal,Barisal Sadar (Kotwali),Shayestabad,70,0,70,0,70,0,0,0,0
Barisal,Barisal,Barisal Sadar (Kotwali),Chandra Mohan,56,0,56,0,56,0,0,0,0
Barisal,Barisal,Barisal Sadar (Kotwali),Ward No-24,2,0,2,0,2,0,0,0,0
Barisal,Barisal,Barisal Sadar (Kotwali),Ward No-30,12,0,12,0,12,0,0,0,0
Barisal,Barisal,Barisal Sadar (Kotwali),Ward No-28,3,0,3,0,3,0,0,0,0
Barisal,Barisal,Barisal Sadar (Kotwali),Ward No-25,5,0,5,0,5,0,0,0,0
Barisal,Barisal,Barisal Sadar (Kotwali),Ward No-23,1,0,1,0,1,0,0,0,0
Barisal,Barisal,Barisal Sadar (Kotwali),Ward No-04,4,0,4,0,4,0,0,0,0
Barisal,Barisal,Barisal Sadar (Kotwali),Ward No-12,1,0,1,0,1,0,0,0,0
Barisal,Barisal,Barisal Sadar (Kotwali),Ward No-29,3,0,3,0,3,0,0,0,0
Barisal,Barisal,Barisal Sadar (Kotwali),Ward No-22,1,0,1,0,1,0,0,0,0
Barisal,Barisal,Barisal Sadar (Kotwali),Ward No-16,1,0,1,0,1,0,0,0,0
Barisal,Barisal,Barisal Sadar (Kotwali),Ward No-10,2,0,2,0,2,0,0,0,0
Barisal,Barisal,Barisal Sadar (Kotwali),Ward No-01,2,1,1,0,1,0,1,0,0
Barisal,Barisal,Barisal Sadar (Kotwali),Ward No-21,3,0,3,0,3,0,0,0,0
Barisal,Barisal,Barisal Sadar (Kotwali),Ward No-02,0,0,0,0,0,0,0,0,0
Barisal,Barisal,Barisal Sadar (Kotwali),Ward No-06,0,0,0,0,0,0,0,0,0
Barisal,Barisal,Barisal Sadar (Kotwali),Ward No-07,0,0,0,0,0,0,0,0,0
Barisal,Barisal,Barisal Sadar (Kotwali),Ward No-08,0,0,0,0,0,0,0,0,0
Barisal,Barisal,Barisal Sadar (Kotwali),Ward No-09,0,0,0,0,0,0,0,0,0
Barisal,Barisal,Barisal Sadar (Kotwali),Ward No-11,0,0,0,0,0,0,0,0,0
Barisal,Barisal,Barisal Sadar (Kotwali),Ward No-13,0,0,0,0,0,0,0,0,0
Barisal,Barisal,Barisal Sadar (Kotwali),Ward No-14,0,0,0,0,0,0,0,0,0
Barisal,Barisal,Barisal Sadar (Kotwali),Ward No-15,0,0,0,0,0,0,0,0,0
Barisal,Barisal,Barisal Sadar (Kotwali),Ward No-17,0,0,0,0,0,0,0,0,0
Barisal,Barisal,Barisal Sadar (Kotwali),Ward No-18,0,0,0,0,0,0,0,0,0
Barisal,Barisal,Barisal Sadar (Kotwali),Ward No-19,0,0,0,0,0,0,0,0,0
Barisal,Barisal,Barisal Sadar (Kotwali),Ward No-20,0,0,0,0,0,0,0,0,0
Barisal,Barisal,Barisal Sadar (Kotwali),###,826,6,820,0,820,0,6,0,0
Barisal,Barisal,Wazirpur,Bamrail,75,0,75,0,75,0,0,0,0
Barisal,Barisal,Wazirpur,Satla,101,0,101,0,101,0,0,0,0
Barisal,Barisal,Wazirpur,Harta,108,0,108,0,108,0,0,0,0
Barisal,Barisal,Wazirpur,Shikarpur,47,1,46,0,46,0,1,0,0
Barisal,Barisal,Wazirpur,Sholak,105,2,103,0,103,0,2,0,0
Barisal,Barisal,Wazirpur,Otra,133,0,133,0,133,0,0,0,0
Barisal,Barisal,Wazirpur,Bara Kotha,77,1,76,0,76,0,1,0,0
Barisal,Barisal,Wazirpur,Guthia,99,0,99,0,99,0,0,0,0
Barisal,Barisal,Wazirpur,Jalla,159,0,159,0,159,0,0,0,0
Barisal,Barisal,Wazirpur,###,904,4,900,0,900,0,4,0,0
Barisal,Barisal,Banari Para,Iluhar,98,0,98,0,98,0,0,0,0
Barisal,Barisal,Banari Para,Bisarkandi,78,0,78,0,78,0,0,0,0
Barisal,Barisal,Banari Para,Banari Para,65,2,63,0,63,0,2,0,0
Barisal,Barisal,Banari Para,Salia Bakpur,74,1,73,0,73,0,1,0,0
Barisal,Barisal,Banari Para,Udaykati,68,0,68,0,68,0,0,0,0
Barisal,Barisal,Banari Para,Chakhar,70,0,70,0,70,0,0,0,0
Barisal,Barisal,Banari Para,Baisari Para,63,1,62,0,62,0,1,0,0
Barisal,Barisal,Banari Para,Saidkati,109,0,109,0,109,0,0,0,0
Barisal,Barisal,Banari Para,Paurashava,0,0,0,0,0,0,0,0,0
Barisal,Barisal,Banari Para,###,625,4,621,0,621,0,4,0,0
Barisal,Barisal,Mehendiganj,Andhar Manik,2,0,2,0,2,0,0,0,0
Barisal,Barisal,Mehendiganj,Bhasan Char,1,0,1,0,1,0,0,0,0
Barisal,Barisal,Mehendiganj,Jangalia,1,0,1,0,1,0,0,0,0
Barisal,Barisal,Mehendiganj,Paurashava,2,1,1,0,1,0,1,0,0
Barisal,Barisal,Mehendiganj,Bidyanandapur,1,0,1,0,1,0,0,0,0
Barisal,Barisal,Mehendiganj,Ulania,2,1,1,0,1,0,1,0,0
Barisal,Barisal,Mehendiganj,Dari Char Khajuria,1,0,1,0,1,0,0,0,0
Barisal,Barisal,Mehendiganj,Alimabad,0,0,0,0,0,0,0,0,0
Barisal,Barisal,Mehendiganj,Chandpur,0,0,0,0,0,0,0,0,0
Barisal,Barisal,Mehendiganj,Char Ekkaria,0,0,0,0,0,0,0,0,0
Barisal,Barisal,Mehendiganj,Char Gopalpur,0,0,0,0,0,0,0,0,0
Barisal,Barisal,Mehendiganj,Gobindapur,0,0,0,0,0,0,0,0,0
Barisal,Barisal,Mehendiganj,Lata,0,0,0,0,0,0,0,0,0
Barisal,Barisal,Mehendiganj,Mehendiganj,0,0,0,0,0,0,0,0,0
Barisal,Barisal,Mehendiganj,###,10,2,8,0,8,0,2,0,0
Barisal,Barisal,Bakerganj,Darial,147,0,147,0,147,0,0,0,0
Barisal,Barisal,Bakerganj,Padri Shibpur,122,0,122,0,122,0,0,0,0
Barisal,Barisal,Bakerganj,Bhar Pasha,107,1,106,0,106,0,1,0,0
Barisal,Barisal,Bakerganj,Niamati,129,0,129,0,129,0,0,0,0
Barisal,Barisal,Bakerganj,Rangasree,85,1,84,0,84,0,1,0,0
Barisal,Barisal,Bakerganj,Kalaskati,118,0,118,0,118,0,0,0,0
Barisal,Barisal,Bakerganj,Garuria,138,0,138,0,138,0,0,0,0
Barisal,Barisal,Bakerganj,Kabai,76,0,76,0,76,0,0,0,0
Barisal,Barisal,Bakerganj,Nalua,67,0,67,0,67,0,0,0,0
Barisal,Barisal,Bakerganj,Durga Pasha,49,0,49,0,49,0,0,0,0
Barisal,Barisal,Bakerganj,Faridpur,87,0,87,0,87,0,0,0,0
Barisal,Barisal,Bakerganj,Dudhal,114,0,114,0,114,0,0,0,0
Barisal,Barisal,Bakerganj,Char Amaddi,105,0,105,0,105,0,0,0,0
Barisal,Barisal,Bakerganj,Charadi,100,0,100,0,100,0,0,0,0
Barisal,Barisal,Bakerganj,Paurashava,1,0,1,0,1,0,0,0,0
Barisal,Barisal,Bakerganj,###,1445,2,1443,0,1443,0,2,0,0
Barisal,Barisal,Babuganj,Madhab Pasha,7,1,6,0,6,0,1,0,0
Barisal,Barisal,Babuganj,Chandpasha,5,1,4,1,3,0,1,0,0
Barisal,Barisal,Babuganj,Dehergati,4,1,3,0,3,1,0,0,0
Barisal,Barisal,Babuganj,Kedarpur,3,1,2,0,2,0,1,0,0
Barisal,Barisal,Babuganj,Rahmatpur,2,1,1,0,1,0,1,0,0
Barisal,Barisal,Babuganj,Agarpur,13,0,13,0,13,0,0,0,0
Barisal,Barisal,Babuganj,###,34,5,29,1,28,1,4,0,0
Barisal,Barisal,Muladi,Kazir Char,2,1,1,0,1,0,1,0,0
Barisal,Barisal,Muladi,Batamara,3,1,2,0,2,1,0,0,0
Barisal,Barisal,Muladi,Gachhua,1,0,1,0,1,0,0,0,0
Barisal,Barisal,Muladi,Char Kalekhan,1,0,1,0,1,0,0,0,0
Barisal,Barisal,Muladi,Muladi,4,0,4,0,4,0,0,0,0
Barisal,Barisal,Muladi,Nazirpur,4,0,4,0,4,0,0,0,0
Barisal,Barisal,Muladi,Paurashava,1,0,1,0,1,0,0,0,0
Barisal,Barisal,Muladi,Safipur,0,0,0,0,0,0,0,0,0
Barisal,Barisal,Muladi,###,16,2,14,0,14,1,1,0,0
Barisal,Barisal,Agailjhara,Ratnapur,54,0,54,0,54,0,0,0,0
Barisal,Barisal,Agailjhara,Bakal,204,2,202,0,202,1,1,0,0
Barisal,Barisal,Agailjhara,Gaila,114,2,112,0,112,0,2,0,0
Barisal,Barisal,Agailjhara,Rajiher,70,1,69,1,68,0,1,0,0
Barisal,Barisal,Agailjhara,Bagdha,29,1,28,0,28,0,1,0,0
Barisal,Barisal,Agailjhara,###,471,6,465,1,464,1,5,0,0
Barisal,Barisal,Hizla,Guabaria,1,0,1,0,1,0,0,0,0
Barisal,Barisal,Hizla,Harinathpur,1,0,1,0,1,0,0,0,0
Barisal,Barisal,Hizla,Memania,1,0,1,0,1,0,0,0,0
Barisal,Barisal,Hizla,Bara Jalia,2,2,0,0,0,1,1,0,0
Barisal,Barisal,Hizla,Hizla Gaurabdi,1,0,1,0,1,0,0,0,0
Barisal,Barisal,Hizla,Dhulkhola,0,0,0,0,0,0,0,0,0
Barisal,Barisal,Hizla,###,6,2,4,0,4,1,1,0,0
Barisal,Barisal,###,###,4494,39,4455,2,4453,4,34,1,0
Barisal,Patuakhali,Dumki,Muradia,37,0,37,0,37,0,0,0,0
Barisal,Patuakhali,Dumki,Angaria,27,0,27,0,27,0,0,0,0
Barisal,Patuakhali,Dumki,Pangashia,26,0,26,0,26,0,0,0,0
Barisal,Patuakhali,Dumki,Lebukhali,60,0,60,0,60,0,0,0,0
Barisal,Patuakhali,Dumki,###,150,0,150,0,150,0,0,0,0
Barisal,Patuakhali,Patuakhali Sadar,Laukati,48,0,48,0,48,0,0,0,0
Barisal,Patuakhali,Patuakhali Sadar,Kalikapur,53,0,53,0,53,0,0,0,0
Barisal,Patuakhali,Patuakhali Sadar,Jainkati,68,0,68,0,68,0,0,0,0
Barisal,Patuakhali,Patuakhali Sadar,Paurashava,56,2,54,0,54,0,2,0,0
Barisal,Patuakhali,Patuakhali Sadar,Bara Bighai,36,0,36,0,36,0,0,0,0
Barisal,Patuakhali,Patuakhali Sadar,Kamalapur,78,0,78,0,78,0,0,0,0
Barisal,Patuakhali,Patuakhali Sadar,Lohalia,24,0,24,0,24,0,0,0,0
Barisal,Patuakhali,Patuakhali Sadar,Badarpur,36,0,36,0,36,0,0,0,0
Barisal,Patuakhali,Patuakhali Sadar,Itabaria,52,0,52,0,52,0,0,0,0
Barisal,Patuakhali,Patuakhali Sadar,Auliapur,48,0,48,0,48,0,0,0,0
Barisal,Patuakhali,Patuakhali Sadar,Marichbunia,53,0,53,0,53,0,0,0,0
Barisal,Patuakhali,Patuakhali Sadar,Chhota Bighai,53,0,53,0,53,0,0,0,0
Barisal,Patuakhali,Patuakhali Sadar,Madarbunia,46,0,46,0,46,0,0,0,0
Barisal,Patuakhali,Patuakhali Sadar,###,651,2,649,0,649,0,2,0,0
Barisal,Patuakhali,Kala Para,Chakamaiya,23,0,23,0,23,0,0,0,0
Barisal,Patuakhali,Kala Para,Nilganj,32,0,32,0,32,0,0,0,0
Barisal,Patuakhali,Kala Para,Paurashava,46,0,46,0,46,0,0,0,0
Barisal,Patuakhali,Kala Para,Tiakhali,46,0,46,0,46,0,0,0,0
Barisal,Patuakhali,Kala Para,Dhankhali,33,0,33,0,33,0,0,0,0
Barisal,Patuakhali,Kala Para,Lata Chapli,83,1,82,0,82,1,0,0,0
Barisal,Patuakhali,Kala Para,Lalua,37,0,37,0,37,0,0,0,0
Barisal,Patuakhali,Kala Para,Mithaganj,13,0,13,0,13,0,0,0,0
Barisal,Patuakhali,Kala Para,Baliatali,14,0,14,0,14,0,0,0,0
Barisal,Patuakhali,Kala Para,Khaprabhanga,51,0,51,0,51,0,0,0,0
Barisal,Patuakhali,Kala Para,Dalbuganj,35,0,35,0,35,0,0,0,0
Barisal,Patuakhali,Kala Para,Dhulasar,45,0,45,0,45,0,0,0,0
Barisal,Patuakhali,Kala Para,###,458,1,457,0,457,1,0,0,0
Barisal,Patuakhali,Bauphal,Daspara,40,0,40,0,40,0,0,0,0
Barisal,Patuakhali,Bauphal,Paurashava,50,0,50,0,50,0,0,0,0
Barisal,Patuakhali,Bauphal,Dhulia,38,0,38,0,38,0,0,0,0
Barisal,Patuakhali,Bauphal,Kanchi Para,32,0,32,0,32,0,0,0,0
Barisal,Patuakhali,Bauphal,Kalisuri,41,0,41,0,41,0,0,0,0
Barisal,Patuakhali,Bauphal,Keshabpur,32,0,32,0,32,0,0,0,0
Barisal,Patuakhali,Bauphal,Surjyamani,26,0,26,0,26,0,0,0,0
Barisal,Patuakhali,Bauphal,Kanakdia,30,0,30,0,30,0,0,0,0
Barisal,Patuakhali,Bauphal,Baga,62,0,62,0,62,0,0,0,0
Barisal,Patuakhali,Bauphal,Noamala,81,0,81,0,81,0,0,0,0
Barisal,Patuakhali,Bauphal,Madanpura,22,0,22,0,22,0,0,0,0
Barisal,Patuakhali,Bauphal,Nazirpur,74,0,74,0,74,0,0,0,0
Barisal,Patuakhali,Bauphal,Kalaiya,40,0,40,0,40,0,0,0,0
Barisal,Patuakhali,Bauphal,Bauphal,50,0,50,0,50,0,0,0,0
Barisal,Patuakhali,Bauphal,Adabaria,59,0,59,0,59,0,0,0,0
Barisal,Patuakhali,Bauphal,###,677,0,677,0,677,0,0,0,0
Barisal,Patuakhali,Dashmina,Dashmina,90,0,90,0,90,0,0,0,0
Barisal,Patuakhali,Dashmina,Betagi Sankipura,24,0,24,0,24,0,0,0,0
Barisal,Patuakhali,Dashmina,Bahrampur,29,0,29,0,29,0,0,0,0
Barisal,Patuakhali,Dashmina,Banshbaria,31,0,31,0,31,0,0,0,0
Barisal,Patuakhali,Dashmina,Rangopaldi,46,0,46,0,46,0,0,0,0
Barisal,Patuakhali,Dashmina,Alipur,72,0,72,0,72,0,0,0,0
Barisal,Patuakhali,Dashmina,###,292,0,292,0,292,0,0,0,0
Barisal,Patuakhali,Galachipa,Paurashava,35,0,35,0,35,0,0,0,0
Barisal,Patuakhali,Galachipa,Amkhola,38,0,38,0,38,0,0,0,0
Barisal,Patuakhali,Galachipa,Golkhali,46,0,46,0,46,0,0,0,0
Barisal,Patuakhali,Galachipa,Bakulbaria,14,0,14,0,14,0,0,0,0
Barisal,Patuakhali,Galachipa,Chiknikandi,44,0,44,0,44,0,0,0,0
Barisal,Patuakhali,Galachipa,Kalyankalas,26,0,26,0,26,0,0,0,0
Barisal,Patuakhali,Galachipa,Gazalia,55,0,55,0,55,0,0,0,0
Barisal,Patuakhali,Galachipa,Galachipa,39,0,39,0,39,0,0,0,0
Barisal,Patuakhali,Galachipa,Ratandi Taltali,31,0,31,0,31,0,0,0,0
Barisal,Patuakhali,Galachipa,Dakua,55,0,55,0,55,0,0,0,0
Barisal,Patuakhali,Galachipa,Panpatty,34,0,34,0,34,0,0,0,0
Barisal,Patuakhali,Galachipa,Char Kajal,33,0,33,0,33,0,0,0,0
Barisal,Patuakhali,Galachipa,Char Biswas,25,0,25,0,25,0,0,0,0
Barisal,Patuakhali,Galachipa,Char Montaz,66,0,66,0,66,0,0,0,0
Barisal,Patuakhali,Galachipa,Rangabali,44,0,44,0,44,0,0,0,0
Barisal,Patuakhali,Galachipa,Chhota Baisdia,67,0,67,0,67,0,0,0,0
Barisal,Patuakhali,Galachipa,Bara Baisdia,39,0,39,0,39,0,0,0,0
Barisal,Patuakhali,Galachipa,Chalitabunia,29,0,29,0,29,0,0,0,0
Barisal,Patuakhali,Galachipa,###,720,0,720,0,720,0,0,0,0
Barisal,Patuakhali,Mirzaganj,Amragachhia,65,0,65,0,65,0,0,0,0
Barisal,Patuakhali,Mirzaganj,Deuli Subidkhali,39,0,39,0,39,0,0,0,0
Barisal,Patuakhali,Mirzaganj,Mirzaganj,40,0,40,0,40,0,0,0,0
Barisal,Patuakhali,Mirzaganj,Karabunia,44,0,44,0,44,0,0,0,0
Barisal,Patuakhali,Mirzaganj,Madhabkhali,72,0,72,0,72,0,0,0,0
Barisal,Patuakhali,Mirzaganj,Majidbari,50,0,50,0,50,0,0,0,0
Barisal,Patuakhali,Mirzaganj,###,310,0,310,0,310,0,0,0,0
Barisal,Patuakhali,###,###,3258,3,3255,0,3255,1,2,0,0
Barisal,Barguna,Amtali,Paurashava,51,0,51,0,51,0,0,0,0
Barisal,Barguna,Amtali,Chowra,48,0,48,0,48,0,0,0,0
Barisal,Barguna,Amtali,Amtali,73,0,73,0,73,0,0,0,0
Barisal,Barguna,Amtali,Gulisakhali,53,0,53,0,53,0,0,0,0
Barisal,Barguna,Amtali,Kukua,29,0,29,0,29,0,0,0,0
Barisal,Barguna,Amtali,Atharagashia,30,0,30,0,30,0,0,0,0
Barisal,Barguna,Amtali,Haldia,85,0,85,0,85,0,0,0,0
Barisal,Barguna,Amtali,Arpangashia,31,0,31,0,31,0,0,0,0
Barisal,Barguna,Amtali,Pancha Koralia,18,0,18,0,18,0,0,0,0
Barisal,Barguna,Amtali,Sarikkhali,13,0,13,0,13,0,0,0,0
Barisal,Barguna,Amtali,Karaibaria,17,0,17,0,17,0,0,0,0
Barisal,Barguna,Amtali,Barabagi,31,0,31,0,31,0,0,0,0
Barisal,Barguna,Amtali,Nishanbaria,64,0,64,0,64,0,0,0,0
Barisal,Barguna,Amtali,Chhota Bagi,11,0,11,0,11,0,0,0,0
Barisal,Barguna,Amtali,Sonakata,0,0,0,0,0,0,0,0,0
Barisal,Barguna,Amtali,###,554,0,554,0,554,0,0,0,0
Barisal,Barguna,Bamna,Bamna,68,0,68,0,68,0,0,0,0
Barisal,Barguna,Bamna,Bukabunia,38,0,38,0,38,0,0,0,0
Barisal,Barguna,Bamna,Ramna,39,1,38,0,38,0,1,0,0
Barisal,Barguna,Bamna,Dauatala,78,0,78,0,78,0,0,0,0
Barisal,Barguna,Bamna,###,223,1,222,0,222,0,1,0,0
Barisal,Barguna,Betagi,Paurashava,37,1,36,0,36,0,1,0,0
Barisal,Barguna,Betagi,Betagi,47,0,47,0,47,0,0,0,0
Barisal,Barguna,Betagi,Sarishamuri,91,0,91,0,91,0,0,0,0
Barisal,Barguna,Betagi,Bibichini,27,0,27,0,27,0,0,0,0
Barisal,Barguna,Betagi,Mokamia,42,0,42,0,42,0,0,0,0
Barisal,Barguna,Betagi,Hosnabad,35,0,35,0,35,0,0,0,0
Barisal,Barguna,Betagi,Bura Mazumdar,36,0,36,0,36,0,0,0,0
Barisal,Barguna,Betagi,Kazirabad,22,0,22,0,22,0,0,0,0
Barisal,Barguna,Betagi,###,337,1,336,0,336,0,1,0,0
Barisal,Barguna,Patharghata,Raihanpur,69,0,69,0,69,0,0,0,0
Barisal,Barguna,Patharghata,Kakchira,80,0,80,0,80,0,0,0,0
Barisal,Barguna,Patharghata,Kalmegha,86,0,86,0,86,0,0,0,0
Barisal,Barguna,Patharghata,Nachna Para,2,0,2,0,2,0,0,0,0
Barisal,Barguna,Patharghata,Kanthaltali,3,0,3,0,3,0,0,0,0
Barisal,Barguna,Patharghata,Paurashava,1,1,0,0,0,1,0,0,0
Barisal,Barguna,Patharghata,Char Duanti,0,0,0,0,0,0,0,0,0
Barisal,Barguna,Patharghata,Patharghata,0,0,0,0,0,0,0,0,0
Barisal,Barguna,Patharghata,###,241,1,240,0,240,1,0,0,0
Barisal,Barguna,Barguna Sadar,Badarkhali,82,0,82,0,82,0,0,0,0
Barisal,Barguna,Barguna Sadar,Gaurichanna,67,0,67,0,67,0,0,0,0
Barisal,Barguna,Barguna Sadar,Phuljhury,39,0,39,0,39,0,0,0,0
Barisal,Barguna,Barguna Sadar,Keorabunia,62,0,62,0,62,0,0,0,0
Barisal,Barguna,Barguna Sadar,Ayla Patakata,40,0,40,0,40,0,0,0,0
Barisal,Barguna,Barguna Sadar,Burir Char,72,0,72,0,72,0,0,0,0
Barisal,Barguna,Barguna Sadar,Paurashava,25,0,25,0,25,0,0,0,0
Barisal,Barguna,Barguna Sadar,Dhalua,38,0,38,0,38,0,0,0,0
Barisal,Barguna,Barguna Sadar,Barguna,34,0,34,0,34,0,0,0,0
Barisal,Barguna,Barguna Sadar,Naltona,4,0,4,0,4,0,0,0,0
Barisal,Barguna,Barguna Sadar,M.Baliatali,32,0,32,0,32,0,0,0,0
Barisal,Barguna,Barguna Sadar,###,495,0,495,0,495,0,0,0,0
Barisal,Barguna,###,###,1850,3,1847,0,1847,1,2,0,0
Barisal,Pirojpur,Bhandaria,Bhandaria,66,2,64,0,64,0,2,0,0
Barisal,Pirojpur,Bhandaria,Gauripur,53,2,51,0,51,1,1,0,0
Barisal,Pirojpur,Bhandaria,Bhitabaria,69,0,69,0,69,0,0,0,0
Barisal,Pirojpur,Bhandaria,Nudmulla,77,1,76,0,76,0,1,0,0
Barisal,Pirojpur,Bhandaria,Dhaoa,26,0,26,0,26,0,0,0,0
Barisal,Pirojpur,Bhandaria,Ikri,0,0,0,0,0,0,0,0,0
Barisal,Pirojpur,Bhandaria,Telikhali,0,0,0,0,0,0,0,0,0
Barisal,Pirojpur,Bhandaria,###,291,5,286,0,286,1,4,0,0
Barisal,Pirojpur,Nesarabad (Swarupkati),Samudaykati,56,0,56,0,56,0,0,0,0
Barisal,Pirojpur,Nesarabad (Swarupkati),Atghar Kuriana,36,1,35,0,35,0,0,1,0
Barisal,Pirojpur,Nesarabad (Swarupkati),Nesarabad (Swarupkati),45,0,45,0,45,0,0,0,0
Barisal,Pirojpur,Nesarabad (Swarupkati),Sutiakati,42,0,42,0,42,0,0,0,0
Barisal,Pirojpur,Nesarabad (Swarupkati),Baldia,77,0,77,0,77,0,0,0,0
Barisal,Pirojpur,Nesarabad (Swarupkati),Daihari,38,0,38,0,38,0,0,0,0
Barisal,Pirojpur,Nesarabad (Swarupkati),Guarekha,37,1,36,0,36,0,1,0,0
Barisal,Pirojpur,Nesarabad (Swarupkati),Jalabari,45,1,44,0,44,0,1,0,0
Barisal,Pirojpur,Nesarabad (Swarupkati),Paurashava,11,1,10,0,10,1,0,0,0
Barisal,Pirojpur,Nesarabad (Swarupkati),Sohagdal,36,0,36,0,36,0,0,0,0
Barisal,Pirojpur,Nesarabad (Swarupkati),Sarengkati,33,1,32,0,32,1,0,0,0
Barisal,Pirojpur,Nesarabad (Swarupkati),###,456,5,451,0,451,2,2,1,0
Barisal,Pirojpur,Pirojpur Sadar,Kalakhali,79,0,79,0,79,0,0,0,0
Barisal,Pirojpur,Pirojpur Sadar,Durgapur,46,0,46,0,46,0,0,0,0
Barisal,Pirojpur,Pirojpur Sadar,Tona,53,2,51,0,51,0,2,0,0
Barisal,Pirojpur,Pirojpur Sadar,Sariktala,61,1,60,0,60,1,0,0,0
Barisal,Pirojpur,Pirojpur Sadar,Kadamtala,7,1,6,0,6,0,1,0,0
Barisal,Pirojpur,Pirojpur Sadar,Shankarpasha,5,3,2,0,2,1,2,0,0
Barisal,Pirojpur,Pirojpur Sadar,Paurashava,1,1,0,0,0,0,1,0,0
Barisal,Pirojpur,Pirojpur Sadar,Sikdar Mallik,1,1,0,0,0,0,1,0,0
Barisal,Pirojpur,Pirojpur Sadar,###,253,9,244,0,244,2,7,0,0
Barisal,Pirojpur,Nazirpur,Purba Deulbaridobra,4,0,4,0,4,0,0,0,0
Barisal,Pirojpur,Nazirpur,Sreeramkati,4,1,3,0,3,1,0,0,0
Barisal,Pirojpur,Nazirpur,Shankharikati,3,2,1,0,1,0,2,0,0
Barisal,Pirojpur,Nazirpur,Sekhmatia,1,1,0,0,0,0,1,0,0
Barisal,Pirojpur,Nazirpur,Dirgha,0,0,0,0,0,0,0,0,0
Barisal,Pirojpur,Nazirpur,Malikhali,0,0,0,0,0,0,0,0,0
Barisal,Pirojpur,Nazirpur,Matibhanga,0,0,0,0,0,0,0,0,0
Barisal,Pirojpur,Nazirpur,Nazirpur,0,0,0,0,0,0,0,0,0
Barisal,Pirojpur,Nazirpur,###,12,4,8,0,8,1,3,0,0
Barisal,Pirojpur,Mathbaria,Tikikata,2,0,2,0,2,0,0,0,0
Barisal,Pirojpur,Mathbaria,Gulishakhali,8,0,8,0,8,0,0,0,0
Barisal,Pirojpur,Mathbaria,Sapleza,2,1,1,0,1,1,0,0,0
Barisal,Pirojpur,Mathbaria,Mathbaria,2,2,0,0,0,2,0,0,0
Barisal,Pirojpur,Mathbaria,Dhanisafa,2,2,0,0,0,1,1,0,0
Barisal,Pirojpur,Mathbaria,Mirukhali,1,1,0,0,0,1,0,0,0
Barisal,Pirojpur,Mathbaria,Amragachhia,1,1,0,0,0,1,0,0,0
Barisal,Pirojpur,Mathbaria,Bara Machhua,0,0,0,0,0,0,0,0,0
Barisal,Pirojpur,Mathbaria,Betmore Rajpara,0,0,0,0,0,0,0,0,0
Barisal,Pirojpur,Mathbaria,Daudkhali,0,0,0,0,0,0,0,0,0
Barisal,Pirojpur,Mathbaria,Paurashava,0,0,0,0,0,0,0,0,0
Barisal,Pirojpur,Mathbaria,Tushkhali,0,0,0,0,0,0,0,0,0
Barisal,Pirojpur,Mathbaria,###,18,7,11,0,11,6,1,0,0
Barisal,Pirojpur,Kawkhali,Shialkati,4,1,3,0,3,0,1,0,0
Barisal,Pirojpur,Kawkhali,Kawkhali,3,2,1,0,1,1,1,0,0
Barisal,Pirojpur,Kawkhali,Chira Para Parsaturia,1,0,1,0,1,0,0,0,0
Barisal,Pirojpur,Kawkhali,Amrajuri,1,1,0,0,0,1,0,0,0
Barisal,Pirojpur,Kawkhali,Sayna Raghunathpur,0,0,0,0,0,0,0,0,0
Barisal,Pirojpur,Kawkhali,###,9,4,5,0,5,2,2,0,0
Barisal,Pirojpur,Zianagar,Pattashi,1,0,1,0,1,0,0,0,0
Barisal,Pirojpur,Zianagar,Bali Para,0,0,0,0,0,0,0,0,0
Barisal,Pirojpur,Zianagar,Parerhat,0,0,0,0,0,0,0,0,0
Barisal,Pirojpur,Zianagar,###,1,0,1,0,1,0,0,0,0
Barisal,Pirojpur,###,###,1040,34,1006,0,1006,14,19,1,0
Barisal,Jhalokati,Jhalokati Sadar,Paurashava,4,1,3,0,3,0,1,0,0
Barisal,Jhalokati,Jhalokati Sadar,Binoykati,67,1,66,0,66,1,0,0,0
Barisal,Jhalokati,Jhalokati Sadar,Ponabalia,6,0,6,0,6,0,0,0,0
Barisal,Jhalokati,Jhalokati Sadar,Keora,32,0,32,0,32,0,0,0,0
Barisal,Jhalokati,Jhalokati Sadar,Kirtipasha,2,1,1,0,1,0,1,0,0
Barisal,Jhalokati,Jhalokati Sadar,Nabagram,2,0,2,0,2,0,0,0,0
Barisal,Jhalokati,Jhalokati Sadar,Basanda,3,1,2,0,2,0,1,0,0
Barisal,Jhalokati,Jhalokati Sadar,Gabkhan Dhansiri,23,0,23,0,23,0,0,0,0
Barisal,Jhalokati,Jhalokati Sadar,Sekherhat,26,0,26,0,26,0,0,0,0
Barisal,Jhalokati,Jhalokati Sadar,Nathullabad,2,0,2,0,2,0,0,0,0
Barisal,Jhalokati,Jhalokati Sadar,Gabha Ramchandrapur,52,0,52,0,52,0,0,0,0
Barisal,Jhalokati,Jhalokati Sadar,###,219,4,215,0,215,1,3,0,0
Barisal,Jhalokati,Nalchity,Siddhakati,36,0,36,0,36,0,0,0,0
Barisal,Jhalokati,Nalchity,Magar,2,1,1,0,1,1,0,0,0
Barisal,Jhalokati,Nalchity,Dapdapia,10,1,9,0,9,0,1,0,0
Barisal,Jhalokati,Nalchity,Kusanghal,1,0,1,0,1,0,0,0,0
Barisal,Jhalokati,Nalchity,Subidpur,1,0,1,0,1,0,0,0,0
Barisal,Jhalokati,Nalchity,Bharabpasha,1,1,0,0,0,1,0,0,0
Barisal,Jhalokati,Nalchity,Paurashava,1,1,0,0,0,0,1,0,0
Barisal,Jhalokati,Nalchity,Kulkati,0,0,0,0,0,0,0,0,0
Barisal,Jhalokati,Nalchity,Mollahat,0,0,0,0,0,0,0,0,0
Barisal,Jhalokati,Nalchity,Nachan Mohal,0,0,0,0,0,0,0,0,0
Barisal,Jhalokati,Nalchity,Ranapasha,0,0,0,0,0,0,0,0,0
Barisal,Jhalokati,Nalchity,###,52,4,48,0,48,2,2,0,0
Barisal,Jhalokati,Kanthalia,Kanthalia,75,1,74,0,74,1,0,0,0
Barisal,Jhalokati,Kanthalia,Amua,5,1,4,0,4,1,0,0,0
Barisal,Jhalokati,Kanthalia,Adrabunia,75,0,75,0,75,0,0,0,0
Barisal,Jhalokati,Kanthalia,Sauljalia,84,0,84,0,84,0,0,0,0
Barisal,Jhalokati,Kanthalia,Chenchri Rampur,3,0,3,0,3,0,0,0,0
Barisal,Jhalokati,Kanthalia,Patkelghata,0,0,0,0,0,0,0,0,0
Barisal,Jhalokati,Kanthalia,###,242,2,240,0,240,2,0,0,0
Barisal,Jhalokati,Rajapur,Baruia,1,0,1,0,1,0,0,0,0
Barisal,Jhalokati,Rajapur,Saturia,4,1,3,0,3,1,0,0,0
Barisal,Jhalokati,Rajapur,Galua,2,0,2,0,2,0,0,0,0
Barisal,Jhalokati,Rajapur,Mathbari,2,0,2,0,2,0,0,0,0
Barisal,Jhalokati,Rajapur,Rajapur,3,2,1,0,1,1,1,0,0
Barisal,Jhalokati,Rajapur,Suktagarh,1,0,1,0,1,0,0,0,0
Barisal,Jhalokati,Rajapur,###,13,3,10,0,10,2,1,0,0
Barisal,Jhalokati,###,###,526,13,513,0,513,7,6,0,0
Barisal,Bhola,Char Fasson,Char Madras,1,0,1,0,1,0,0,0,0
Barisal,Bhola,Char Fasson,Nilkamal,1,0,1,0,1,0,0,0,0
Barisal,Bhola,Char Fasson,Jahanpur,1,0,1,0,1,0,0,0,0
Barisal,Bhola,Char Fasson,Paurashava,3,0,3,0,3,0,0,0,0
Barisal,Bhola,Char Fasson,Jinnaghar,2,0,2,0,2,0,0,0,0
Barisal,Bhola,Char Fasson,Ewajpur,1,0,1,0,1,0,0,0,0
Barisal,Bhola,Char Fasson,Aslampur,2,0,2,0,2,0,0,0,0
Barisal,Bhola,Char Fasson,Char Kalmi,1,0,1,0,1,0,0,0,0
Barisal,Bhola,Char Fasson,Aminabad,1,0,1,0,1,0,0,0,0
Barisal,Bhola,Char Fasson,Nurabad,2,0,2,0,2,0,0,0,0
Barisal,Bhola,Char Fasson,Abdullapur,0,0,0,0,0,0,0,0,0
Barisal,Bhola,Char Fasson,Abu Bakarpur,0,0,0,0,0,0,0,0,0
Barisal,Bhola,Char Fasson,Adhakha Nazrul Nagar,0,0,0,0,0,0,0,0,0
Barisal,Bhola,Char Fasson,Char Kukri Mukri,0,0,0,0,0,0,0,0,0
Barisal,Bhola,Char Fasson,Char Manika,0,0,0,0,0,0,0,0,0
Barisal,Bhola,Char Fasson,Dhal Char,0,0,0,0,0,0,0,0,0
Barisal,Bhola,Char Fasson,Hazariganj,0,0,0,0,0,0,0,0,0
Barisal,Bhola,Char Fasson,Mujib Nagar,0,0,0,0,0,0,0,0,0
Barisal,Bhola,Char Fasson,Osmanganj,0,0,0,0,0,0,0,0,0
Barisal,Bhola,Char Fasson,Rasul Pur,0,0,0,0,0,0,0,0,0
Barisal,Bhola,Char Fasson,###,15,0,15,0,15,0,0,0,0
Barisal,Bhola,Lalmohan,Paschim Char Umed,3,0,3,0,3,0,0,0,0
Barisal,Bhola,Lalmohan,Dhali Gaurnagar,3,0,3,0,3,0,0,0,0
Barisal,Bhola,Lalmohan,Lord Hardinje,3,0,3,0,3,0,0,0,0
Barisal,Bhola,Lalmohan,Kalma,1,0,1,0,1,0,0,0,0
Barisal,Bhola,Lalmohan,Paurashava,3,1,2,0,2,0,0,1,0
Barisal,Bhola,Lalmohan,Badarpur,1,0,1,0,1,0,0,0,0
Barisal,Bhola,Lalmohan,Char Bhuta,0,0,0,0,0,0,0,0,0
Barisal,Bhola,Lalmohan,Farazganj,0,0,0,0,0,0,0,0,0
Barisal,Bhola,Lalmohan,Lalmohan,0,0,0,0,0,0,0,0,0
Barisal,Bhola,Lalmohan,Ramganj,0,0,0,0,0,0,0,0,0
Barisal,Bhola,Lalmohan,###,14,1,13,0,13,0,0,1,0
Barisal,Bhola,Bhola Sadar,Paschim Illisha,2,0,2,0,2,0,0,0,0
Barisal,Bhola,Bhola Sadar,Bhedaria,1,0,1,0,1,0,0,0,0
Barisal,Bhola,Bhola Sadar,Uttar Dighaldi,1,0,1,0,1,0,0,0,0
Barisal,Bhola,Bhola Sadar,Char Samaia,2,0,2,0,2,0,0,0,0
Barisal,Bhola,Bhola Sadar,Dakshin Dighaldi,1,0,1,0,1,0,0,0,0
Barisal,Bhola,Bhola Sadar,Char Shibpur,1,0,1,0,1,0,0,0,0
Barisal,Bhola,Bhola Sadar,Paurashava,3,1,2,0,2,1,0,0,0
Barisal,Bhola,Bhola Sadar,Alinagar,0,0,0,0,0,0,0,0,0
Barisal,Bhola,Bhola Sadar,Bapta,0,0,0,0,0,0,0,0,0
Barisal,Bhola,Bhola Sadar,Bhelu Miah,0,0,0,0,0,0,0,0,0
Barisal,Bhola,Bhola Sadar,Dhania,0,0,0,0,0,0,0,0,0
Barisal,Bhola,Bhola Sadar,Illisha,0,0,0,0,0,0,0,0,0
Barisal,Bhola,Bhola Sadar,Kachia,0,0,0,0,0,0,0,0,0
Barisal,Bhola,Bhola Sadar,Rajapur,0,0,0,0,0,0,0,0,0
Barisal,Bhola,Bhola Sadar,###,11,1,10,0,10,1,0,0,0
Barisal,Bhola,Manpura,Hajirhat,2,0,2,0,2,0,0,0,0
Barisal,Bhola,Manpura,Dakshin Sakuchia,0,0,0,0,0,0,0,0,0
Barisal,Bhola,Manpura,Manpura,0,0,0,0,0,0,0,0,0
Barisal,Bhola,Manpura,Uttar Sakuchia,0,0,0,0,0,0,0,0,0
Barisal,Bhola,Manpura,###,2,0,2,0,2,0,0,0,0
Barisal,Bhola,Tazumuddin,Chandpur,4,0,4,0,4,0,0,0,0
Barisal,Bhola,Tazumuddin,Shambhupur,4,0,4,0,4,0,0,0,0
Barisal,Bhola,Tazumuddin,Chanchra,1,0,1,0,1,0,0,0,0
Barisal,Bhola,Tazumuddin,Bara Malancha,0,0,0,0,0,0,0,0,0
Barisal,Bhola,Tazumuddin,Sonapur,0,0,0,0,0,0,0,0,0
Barisal,Bhola,Tazumuddin,###,9,0,9,0,9,0,0,0,0
Barisal,Bhola,Daulatkhan,Dakshin Joynagar,2,0,2,0,2,0,0,0,0
Barisal,Bhola,Daulatkhan,Char Pata,1,0,1,0,1,0,0,0,0
Barisal,Bhola,Daulatkhan,Uttar Joynagar,2,0,2,0,2,0,0,0,0
Barisal,Bhola,Daulatkhan,Medua,2,0,2,0,2,0,0,0,0
Barisal,Bhola,Daulatkhan,Paurashava,1,0,1,0,1,0,0,0,0
Barisal,Bhola,Daulatkhan,Char Khalifa,2,0,2,0,2,0,0,0,0
Barisal,Bhola,Daulatkhan,Bhabanipur,0,0,0,0,0,0,0,0,0
Barisal,Bhola,Daulatkhan,Hajipur,0,0,0,0,0,0,0,0,0
Barisal,Bhola,Daulatkhan,Madanpur,0,0,0,0,0,0,0,0,0
Barisal,Bhola,Daulatkhan,Saidpur,0,0,0,0,0,0,0,0,0
Barisal,Bhola,Daulatkhan,###,10,0,10,0,10,0,0,0,0
Barisal,Bhola,Burhanuddin,Gangapur,1,0,1,0,1,0,0,0,0
Barisal,Bhola,Burhanuddin,Tabgi,4,0,4,0,4,0,0,0,0
Barisal,Bhola,Burhanuddin,Deula,1,0,1,0,1,0,0,0,0
Barisal,Bhola,Burhanuddin,Kachia,1,0,1,0,1,0,0,0,0
Barisal,Bhola,Burhanuddin,Paurashava,1,0,1,0,1,0,0,0,0
Barisal,Bhola,Burhanuddin,Bara Manika,1,0,1,0,1,0,0,0,0
Barisal,Bhola,Burhanuddin,Hassan Nagar,0,0,0,0,0,0,0,0,0
Barisal,Bhola,Burhanuddin,Kutba,0,0,0,0,0,0,0,0,0
Barisal,Bhola,Burhanuddin,Pakshia,0,0,0,0,0,0,0,0,0
Barisal,Bhola,Burhanuddin,Sachra,0,0,0,0,0,0,0,0,0
Barisal,Bhola,Burhanuddin,###,9,0,9,0,9,0,0,0,0
Barisal,Bhola,###,###,70,2,68,0,68,1,0,1,0
Barisal,###,###,###,11238,94,11144,2,11142,28,63,3,0
Sylhet,Sunamganj,Chhatak,Bhatgaon,2,0,2,0,2,0,0,0,0
Sylhet,Sunamganj,Chhatak,Kalaruka,2,0,2,0,2,0,0,0,0
Sylhet,Sunamganj,Chhatak,Saidergaon,2,0,2,0,2,0,0,0,0
Sylhet,Sunamganj,Chhatak,Uttar Khurma,1,0,1,1,0,0,0,0,0
Sylhet,Sunamganj,Chhatak,Dakshin Khurma,1,0,1,1,0,0,0,0,0
Sylhet,Sunamganj,Chhatak,Chhatak Paurashava,1,0,1,1,0,0,0,0,0
Sylhet,Sunamganj,Chhatak,Charmohalla Union,0,0,0,0,0,0,0,0,0
Sylhet,Sunamganj,Chhatak,Chhatak,0,0,0,0,0,0,0,0,0
Sylhet,Sunamganj,Chhatak,Dakshin Islampur,0,0,0,0,0,0,0,0,0
Sylhet,Sunamganj,Chhatak,Dular Bazar,0,0,0,0,0,0,0,0,0
Sylhet,Sunamganj,Chhatak,Jawar Bazar,0,0,0,0,0,0,0,0,0
Sylhet,Sunamganj,Chhatak,Noarai,0,0,0,0,0,0,0,0,0
Sylhet,Sunamganj,Chhatak,Saila Afzalabad,0,0,0,0,0,0,0,0,0
Sylhet,Sunamganj,Chhatak,Sing Chapair,0,0,0,0,0,0,0,0,0
Sylhet,Sunamganj,Chhatak,###,9,0,9,3,6,0,0,0,0
Sylhet,Sunamganj,Derai,Jagaddal,3,0,3,1,2,0,0,0,0
Sylhet,Sunamganj,Derai,Charnar Char,2,0,2,0,2,0,0,0,0
Sylhet,Sunamganj,Derai,Rafinagar,2,0,2,0,2,0,0,0,0
Sylhet,Sunamganj,Derai,Kulanj,1,0,1,1,0,0,0,0,0
Sylhet,Sunamganj,Derai,Taral,1,0,1,1,0,0,0,0,0
Sylhet,Sunamganj,Derai,Karimpur,2,0,2,2,0,0,0,0,0
Sylhet,Sunamganj,Derai,Rajanagar,1,0,1,1,0,0,0,0,0
Sylhet,Sunamganj,Derai,Bhati Para,0,0,0,0,0,0,0,0,0
Sylhet,Sunamganj,Derai,Derai Paurashava,0,0,0,0,0,0,0,0,0
Sylhet,Sunamganj,Derai,Derai Sarmangal,0,0,0,0,0,0,0,0,0
Sylhet,Sunamganj,Derai,###,12,0,12,6,6,0,0,0,0
Sylhet,Sunamganj,Dharampasha,Paikurati,3,0,3,1,2,0,0,0,0
Sylhet,Sunamganj,Dharampasha,Dharmapasha,7,0,7,0,7,0,0,0,0
Sylhet,Sunamganj,Dharampasha,Madhyanagar,1,0,1,1,0,0,0,0,0
Sylhet,Sunamganj,Dharampasha,Uttar Sukhair Rajapur,1,0,1,1,0,0,0,0,0
Sylhet,Sunamganj,Dharampasha,Joysree,6,0,6,1,5,0,0,0,0
Sylhet,Sunamganj,Dharampasha,Selborash,8,0,8,1,7,0,0,0,0
Sylhet,Sunamganj,Dharampasha,Dakshin Sukhairrajapur,3,0,3,0,3,0,0,0,0
Sylhet,Sunamganj,Dharampasha,Chamardani,0,0,0,0,0,0,0,0,0
Sylhet,Sunamganj,Dharampasha,Dakshin Bongshikunda,0,0,0,0,0,0,0,0,0
Sylhet,Sunamganj,Dharampasha,Uttar Bangshikunda,0,0,0,0,0,0,0,0,0
Sylhet,Sunamganj,Dharampasha,###,29,0,29,5,24,0,0,0,0
Sylhet,Sunamganj,Jamalganj,Jamalganj,4,0,4,2,2,0,0,0,0
Sylhet,Sunamganj,Jamalganj,Vimkhali,2,0,2,2,0,0,0,0,0
Sylhet,Sunamganj,Jamalganj,Sachna Bazar,1,0,1,1,0,0,0,0,0
Sylhet,Sunamganj,Jamalganj,Fenarbak,1,0,1,1,0,0,0,0,0
Sylhet,Sunamganj,Jamalganj,Beheli,0,0,0,0,0,0,0,0,0
Sylhet,Sunamganj,Jamalganj,###,8,0,8,6,2,0,0,0,0
Sylhet,Sunamganj,Jagannathpur,Asharkandi,2,0,2,0,2,0,0,0,0
Sylhet,Sunamganj,Jagannathpur,Syed Pur,4,0,4,0,4,0,0,0,0
Sylhet,Sunamganj,Jagannathpur,Raniganj,3,0,3,1,2,0,0,0,0
Sylhet,Sunamganj,Jagannathpur,Pailgaon,1,0,1,1,0,0,0,0,0
Sylhet,Sunamganj,Jagannathpur,Jagannathpur Paurashava,2,0,2,2,0,0,0,0,0
Sylhet,Sunamganj,Jagannathpur,Kalkalia,2,0,2,0,2,0,0,0,0
Sylhet,Sunamganj,Jagannathpur,Patali,1,0,1,1,0,0,0,0,0
Sylhet,Sunamganj,Jagannathpur,Mirpur,3,1,2,2,0,0,0,0,1
Sylhet,Sunamganj,Jagannathpur,Haldipur,0,0,0,0,0,0,0,0,0
Sylhet,Sunamganj,Jagannathpur,###,18,1,17,7,10,0,0,0,1
Sylhet,Sunamganj,Dakshin Sunamganj,Durgapasha,4,0,4,0,4,0,0,0,0
Sylhet,Sunamganj,Dakshin Sunamganj,Patharia,5,0,5,1,4,0,0,0,0
Sylhet,Sunamganj,Dakshin Sunamganj,Shimulbak,2,0,2,0,2,0,0,0,0
Sylhet,Sunamganj,Dakshin Sunamganj,Joykalas,1,0,1,1,0,0,0,0,0
Sylhet,Sunamganj,Dakshin Sunamganj,Paschim Pagla,1,0,1,1,0,0,0,0,0
Sylhet,Sunamganj,Dakshin Sunamganj,Purba Pagla,3,0,3,1,2,0,0,0,0
Sylhet,Sunamganj,Dakshin Sunamganj,Paschim Birgaon,0,0,0,0,0,0,0,0,0
Sylhet,Sunamganj,Dakshin Sunamganj,Purba Birgoan,0,0,0,0,0,0,0,0,0
Sylhet,Sunamganj,Dakshin Sunamganj,###,16,0,16,4,12,0,0,0,0
Sylhet,Sunamganj,Sulla,Bahara,4,1,3,1,2,0,0,0,1
Sylhet,Sunamganj,Sulla,Sulla,3,0,3,1,2,0,0,0,0
Sylhet,Sunamganj,Sulla,Atgaon,1,0,1,1,0,0,0,0,0
Sylhet,Sunamganj,Sulla,Habibpur,3,0,3,3,0,0,0,0,0
Sylhet,Sunamganj,Sulla,###,11,1,10,6,4,0,0,0,1
Sylhet,Sunamganj,Dowarabazar,Mannargaon,2,2,0,0,0,0,1,0,1
Sylhet,Sunamganj,Dowarabazar,Surma,2,2,0,0,0,0,1,1,0
Sylhet,Sunamganj,Dowarabazar,Dakshin Dowarabazar,2,1,1,1,0,0,0,1,0
Sylhet,Sunamganj,Dowarabazar,Duhalia,1,1,0,0,0,0,0,1,0
Sylhet,Sunamganj,Dowarabazar,Bangla Bazar,0,0,0,0,0,0,0,0,0
Sylhet,Sunamganj,Dowarabazar,Bougla Bazar,0,0,0,0,0,0,0,0,0
Sylhet,Sunamganj,Dowarabazar,Lakshmipur,0,0,0,0,0,0,0,0,0
Sylhet,Sunamganj,Dowarabazar,Narsing Pur,0,0,0,0,0,0,0,0,0
Sylhet,Sunamganj,Dowarabazar,Pandergaon,0,0,0,0,0,0,0,0,0
Sylhet,Sunamganj,Dowarabazar,###,7,6,1,1,0,0,2,3,1
Sylhet,Sunamganj,Tahirpur,Uttar Badaghat,2,2,0,0,0,1,0,0,1
Sylhet,Sunamganj,Tahirpur,Tahirpur,3,0,3,3,0,0,0,0,0
Sylhet,Sunamganj,Tahirpur,Dakshin Sreepur,1,0,1,1,0,0,0,0,0
Sylhet,Sunamganj,Tahirpur,Dakshin Badal,1,1,0,0,0,0,0,0,1
Sylhet,Sunamganj,Tahirpur,Balijuri,0,0,0,0,0,0,0,0,0
Sylhet,Sunamganj,Tahirpur,Uttar Badal,0,0,0,0,0,0,0,0,0
Sylhet,Sunamganj,Tahirpur,Uttar Sreepur,0,0,0,0,0,0,0,0,0
Sylhet,Sunamganj,Tahirpur,###,7,3,4,4,0,1,0,0,2
Sylhet,Sunamganj,Bishwambarpur,Palash,4,2,2,2,0,1,0,1,0
Sylhet,Sunamganj,Bishwambarpur,Dhonpur,2,2,0,0,0,0,1,1,0
Sylhet,Sunamganj,Bishwambarpur,Sholukabad,1,0,1,1,0,0,0,0,0
Sylhet,Sunamganj,Bishwambarpur,Dakshin Badaghat,4,0,4,4,0,0,0,0,0
Sylhet,Sunamganj,Bishwambarpur,Fatehpur,0,0,0,0,0,0,0,0,0
Sylhet,Sunamganj,Bishwambarpur,###,11,4,7,7,0,1,1,2,0
Sylhet,Sunamganj,Sunamganj Sadar,Katair,1,0,1,1,0,0,0,0,0
Sylhet,Sunamganj,Sunamganj Sadar,Aftabnagar,1,0,1,1,0,0,0,0,0
Sylhet,Sunamganj,Sunamganj Sadar,Lakshmansree,1,0,1,1,0,0,0,0,0
Sylhet,Sunamganj,Sunamganj Sadar,Gourararang,0,0,0,0,0,0,0,0,0
Sylhet,Sunamganj,Sunamganj Sadar,Jahangirnagar,0,0,0,0,0,0,0,0,0
Sylhet,Sunamganj,Sunamganj Sadar,Mohanpur,0,0,0,0,0,0,0,0,0
Sylhet,Sunamganj,Sunamganj Sadar,Mollah Para,0,0,0,0,0,0,0,0,0
Sylhet,Sunamganj,Sunamganj Sadar,Rangar Char,0,0,0,0,0,0,0,0,0
Sylhet,Sunamganj,Sunamganj Sadar,Sunamganj Paurashava,0,0,0,0,0,0,0,0,0
Sylhet,Sunamganj,Sunamganj Sadar,Surma,0,0,0,0,0,0,0,0,0
Sylhet,Sunamganj,Sunamganj Sadar,###,3,0,3,3,0,0,0,0,0
Sylhet,Sunamganj,###,###,131,15,116,52,64,2,3,5,5
Sylhet,Sylhet,Balaganj,Purba Pailanpur,2,0,2,0,2,0,0,0,0
Sylhet,Sylhet,Balaganj,Balaganj,4,1,3,3,0,0,0,1,0
Sylhet,Sylhet,Balaganj,Omarpur,3,1,2,0,2,0,0,1,0
Sylhet,Sylhet,Balaganj,Dayamir,1,1,0,0,0,0,0,0,1
Sylhet,Sylhet,Balaganj,Dewan Bazar,1,1,0,0,0,0,0,0,1
Sylhet,Sylhet,Balaganj,Burunga,1,1,0,0,0,0,0,1,0
Sylhet,Sylhet,Balaganj,Paschim Pailanpur,1,0,1,1,0,0,0,0,0
Sylhet,Sylhet,Balaganj,Boaljur Bazar,0,0,0,0,0,0,0,0,0
Sylhet,Sylhet,Balaganj,Goula Bazar,0,0,0,0,0,0,0,0,0
Sylhet,Sylhet,Balaganj,Osmanpur,0,0,0,0,0,0,0,0,0
Sylhet,Sylhet,Balaganj,Paschim Gauripur,0,0,0,0,0,0,0,0,0
Sylhet,Sylhet,Balaganj,Purba Gauripur,0,0,0,0,0,0,0,0,0
Sylhet,Sylhet,Balaganj,Sadipur,0,0,0,0,0,0,0,0,0
Sylhet,Sylhet,Balaganj,Tajpur,0,0,0,0,0,0,0,0,0
Sylhet,Sylhet,Balaganj,###,13,5,8,4,4,0,0,3,2
Sylhet,Sylhet,Gowainghat,Lengura,3,1,2,0,2,0,0,0,1
Sylhet,Sylhet,Gowainghat,Purba Jaflong,1,1,0,0,0,1,0,0,0
Sylhet,Sylhet,Gowainghat,Fatehpur,1,1,0,0,0,0,1,0,0
Sylhet,Sylhet,Gowainghat,Alirgaon,2,2,0,0,0,0,1,1,0
Sylhet,Sylhet,Gowainghat,Paschim Jaflong,1,1,0,0,0,0,0,0,1
Sylhet,Sylhet,Gowainghat,Towakul,1,1,0,0,0,0,0,0,1
Sylhet,Sylhet,Gowainghat,Nandirgaon,0,0,0,0,0,0,0,0,0
Sylhet,Sylhet,Gowainghat,Rustampur,0,0,0,0,0,0,0,0,0
Sylhet,Sylhet,Gowainghat,###,9,7,2,0,2,1,2,1,3
Sylhet,Sylhet,Fenchuganj,Fenchuganj,3,3,0,0,0,0,1,1,1
Sylhet,Sylhet,Fenchuganj,Gilachhara,3,3,0,0,0,0,2,1,0
Sylhet,Sylhet,Fenchuganj,Maijgaon,0,0,0,0,0,0,0,0,0
Sylhet,Sylhet,Fenchuganj,###,6,6,0,0,0,0,3,2,1
Sylhet,Sylhet,Sylhet Sadar,Ward No-22,1,1,0,0,0,0,0,1,0
Sylhet,Sylhet,Sylhet Sadar,Tuker Bazar,1,1,0,0,0,0,0,1,0
Sylhet,Sylhet,Sylhet Sadar,Khadimnagar,1,1,0,0,0,0,1,0,0
Sylhet,Sylhet,Sylhet Sadar,Ward No-14,1,1,0,0,0,0,0,1,0
Sylhet,Sylhet,Sylhet Sadar,Khadim Para,1,1,0,0,0,0,0,0,1
Sylhet,Sylhet,Sylhet Sadar,Mogalgaon,1,1,0,0,0,0,0,1,0
Sylhet,Sylhet,Sylhet Sadar,Hatkhola,0,0,0,0,0,0,0,0,0
Sylhet,Sylhet,Sylhet Sadar,Jalalabad,0,0,0,0,0,0,0,0,0
Sylhet,Sylhet,Sylhet Sadar,Kandigaon,0,0,0,0,0,0,0,0,0
Sylhet,Sylhet,Sylhet Sadar,Tultikar,0,0,0,0,0,0,0,0,0
Sylhet,Sylhet,Sylhet Sadar,Ward No-01,0,0,0,0,0,0,0,0,0
Sylhet,Sylhet,Sylhet Sadar,Ward No-02,0,0,0,0,0,0,0,0,0
Sylhet,Sylhet,Sylhet Sadar,Ward No-03,0,0,0,0,0,0,0,0,0
Sylhet,Sylhet,Sylhet Sadar,Ward No-04,0,0,0,0,0,0,0,0,0
Sylhet,Sylhet,Sylhet Sadar,Ward No-05,0,0,0,0,0,0,0,0,0
Sylhet,Sylhet,Sylhet Sadar,Ward No-06,0,0,0,0,0,0,0,0,0
Sylhet,Sylhet,Sylhet Sadar,Ward No-07,0,0,0,0,0,0,0,0,0
Sylhet,Sylhet,Sylhet Sadar,Ward No-08,0,0,0,0,0,0,0,0,0
Sylhet,Sylhet,Sylhet Sadar,Ward No-09,0,0,0,0,0,0,0,0,0
Sylhet,Sylhet,Sylhet Sadar,Ward No-10,0,0,0,0,0,0,0,0,0
Sylhet,Sylhet,Sylhet Sadar,Ward No-11,0,0,0,0,0,0,0,0,0
Sylhet,Sylhet,Sylhet Sadar,Ward No-12,0,0,0,0,0,0,0,0,0
Sylhet,Sylhet,Sylhet Sadar,Ward No-13,0,0,0,0,0,0,0,0,0
Sylhet,Sylhet,Sylhet Sadar,Ward No-15,0,0,0,0,0,0,0,0,0
Sylhet,Sylhet,Sylhet Sadar,Ward No-16,0,0,0,0,0,0,0,0,0
Sylhet,Sylhet,Sylhet Sadar,Ward No-17,0,0,0,0,0,0,0,0,0
Sylhet,Sylhet,Sylhet Sadar,Ward No-18,0,0,0,0,0,0,0,0,0
Sylhet,Sylhet,Sylhet Sadar,Ward No-19,0,0,0,0,0,0,0,0,0
Sylhet,Sylhet,Sylhet Sadar,Ward No-20,0,0,0,0,0,0,0,0,0
Sylhet,Sylhet,Sylhet Sadar,Ward No-21,0,0,0,0,0,0,0,0,0
Sylhet,Sylhet,Sylhet Sadar,Ward No-23,0,0,0,0,0,0,0,0,0
Sylhet,Sylhet,Sylhet Sadar,Ward No-24,0,0,0,0,0,0,0,0,0
Sylhet,Sylhet,Sylhet Sadar,Ward No-25,0,0,0,0,0,0,0,0,0
Sylhet,Sylhet,Sylhet Sadar,Ward No-26,0,0,0,0,0,0,0,0,0
Sylhet,Sylhet,Sylhet Sadar,Ward No-27,0,0,0,0,0,0,0,0,0
Sylhet,Sylhet,Sylhet Sadar,###,6,6,0,0,0,0,1,4,1
Sylhet,Sylhet,Beani Bazar,Charkhai,1,1,0,0,0,0,0,1,0
Sylhet,Sylhet,Beani Bazar,Muria,1,1,0,0,0,0,1,0,0
Sylhet,Sylhet,Beani Bazar,Lauta,1,1,0,0,0,1,0,0,0
Sylhet,Sylhet,Beani Bazar,Tilpara,1,1,0,0,0,0,0,1,0
Sylhet,Sylhet,Beani Bazar,Sheola,1,1,0,0,0,0,1,0,0
Sylhet,Sylhet,Beani Bazar,Alinagar,1,1,0,0,0,0,0,1,0
Sylhet,Sylhet,Beani Bazar,Mathiura,1,1,0,0,0,0,0,1,0
Sylhet,Sylhet,Beani Bazar,Dobhag,1,1,0,0,0,0,0,1,0
Sylhet,Sylhet,Beani Bazar,Beani Bazar,0,0,0,0,0,0,0,0,0
Sylhet,Sylhet,Beani Bazar,Beani Bazar Paurashava,0,0,0,0,0,0,0,0,0
Sylhet,Sylhet,Beani Bazar,Kurar Bazar,0,0,0,0,0,0,0,0,0
Sylhet,Sylhet,Beani Bazar,Mollahpur,0,0,0,0,0,0,0,0,0
Sylhet,Sylhet,Beani Bazar,###,8,8,0,0,0,1,2,5,0
Sylhet,Sylhet,Dakshin Surma,Kuchai,1,1,0,0,0,0,0,1,0
Sylhet,Sylhet,Dakshin Surma,Silam,1,1,0,0,0,0,0,1,0
Sylhet,Sylhet,Dakshin Surma,Mogla Bazar,1,0,1,1,0,0,0,0,0
Sylhet,Sylhet,Dakshin Surma,Baraikandi,0,0,0,0,0,0,0,0,0
Sylhet,Sylhet,Dakshin Surma,Daudpur,0,0,0,0,0,0,0,0,0
Sylhet,Sylhet,Dakshin Surma,Jalalpur,0,0,0,0,0,0,0,0,0
Sylhet,Sylhet,Dakshin Surma,Lala Bazar,0,0,0,0,0,0,0,0,0
Sylhet,Sylhet,Dakshin Surma,Mollargaon,0,0,0,0,0,0,0,0,0
Sylhet,Sylhet,Dakshin Surma,Tetli,0,0,0,0,0,0,0,0,0
Sylhet,Sylhet,Dakshin Surma,###,3,2,1,1,0,0,0,2,0
Sylhet,Sylhet,Golabganj,Lakshanaband,1,1,0,0,0,0,0,1,0
Sylhet,Sylhet,Golabganj,Bhadeshwar,2,2,0,0,0,0,1,1,0
Sylhet,Sylhet,Golabganj,Lakshmi Pasha,1,1,0,0,0,0,0,0,1
Sylhet,Sylhet,Golabganj,Golapganj Paurashava,3,1,2,0,2,0,1,0,0
Sylhet,Sylhet,Golabganj,Fulbari,1,1,0,0,0,0,0,0,1
Sylhet,Sylhet,Golabganj,Amura,1,1,0,0,0,0,1,0,0
Sylhet,Sylhet,Golabganj,Bagha,0,0,0,0,0,0,0,0,0
Sylhet,Sylhet,Golabganj,Budbari Bazar,0,0,0,0,0,0,0,0,0
Sylhet,Sylhet,Golabganj,Dhaka Dakshin,0,0,0,0,0,0,0,0,0
Sylhet,Sylhet,Golabganj,Golabganj,0,0,0,0,0,0,0,0,0
Sylhet,Sylhet,Golabganj,Shorifgonj,0,0,0,0,0,0,0,0,0
Sylhet,Sylhet,Golabganj,Uttar Bade Pasha,0,0,0,0,0,0,0,0,0
Sylhet,Sylhet,Golabganj,###,9,7,2,0,2,0,3,2,2
Sylhet,Sylhet,Zakiganj,Zakiganj Paurashava,2,2,0,0,0,0,1,1,0
Sylhet,Sylhet,Zakiganj,Bara Thakuri,1,1,0,0,0,0,0,1,0
Sylhet,Sylhet,Zakiganj,Barahal,1,1,0,0,0,0,0,1,0
Sylhet,Sylhet,Zakiganj,Kholachhara,1,1,0,0,0,0,1,0,0
Sylhet,Sylhet,Zakiganj,Zakiganj,1,1,0,0,0,0,0,1,0
Sylhet,Sylhet,Zakiganj,Manikpur,1,1,0,0,0,0,0,1,0
Sylhet,Sylhet,Zakiganj,Khas Kanakpur,1,1,0,0,0,0,0,1,0
Sylhet,Sylhet,Zakiganj,Birasree,0,0,0,0,0,0,0,0,0
Sylhet,Sylhet,Zakiganj,Kajalshar,0,0,0,0,0,0,0,0,0
Sylhet,Sylhet,Zakiganj,Sultanpur,0,0,0,0,0,0,0,0,0
Sylhet,Sylhet,Zakiganj,###,8,8,0,0,0,0,2,6,0
Sylhet,Sylhet,Bishwanath,Alankari,1,1,0,0,0,0,1,0,0
Sylhet,Sylhet,Bishwanath,Rampasha,1,0,1,1,0,0,0,0,0
Sylhet,Sylhet,Bishwanath,Bishwanath,2,1,1,1,0,0,0,1,0
Sylhet,Sylhet,Bishwanath,Lama Kazi,2,0,2,2,0,0,0,0,0
Sylhet,Sylhet,Bishwanath,Deokalas,1,0,1,1,0,0,0,0,0
Sylhet,Sylhet,Bishwanath,Dasghar,0,0,0,0,0,0,0,0,0
Sylhet,Sylhet,Bishwanath,Daulatpur,0,0,0,0,0,0,0,0,0
Sylhet,Sylhet,Bishwanath,Khazanchigaon,0,0,0,0,0,0,0,0,0
Sylhet,Sylhet,Bishwanath,###,7,2,5,5,0,0,1,1,0
Sylhet,Sylhet,Jaintiapur,Charikata,1,1,0,0,0,0,1,0,0
Sylhet,Sylhet,Jaintiapur,Fatehpur,1,1,0,0,0,0,1,0,0
Sylhet,Sylhet,Jaintiapur,Nijpat,1,1,0,0,0,1,0,0,0
Sylhet,Sylhet,Jaintiapur,Darbasta,1,1,0,0,0,0,1,0,0
Sylhet,Sylhet,Jaintiapur,Jaintapur,1,1,0,0,0,1,0,0,0
Sylhet,Sylhet,Jaintiapur,Chiknagul,0,0,0,0,0,0,0,0,0
Sylhet,Sylhet,Jaintiapur,###,5,5,0,0,0,2,3,0,0
Sylhet,Sylhet,Kanaighat,Jhingrabari,1,1,0,0,0,0,0,1,0
Sylhet,Sylhet,Kanaighat,Purba Dighirpar,1,1,0,0,0,0,0,1,0
Sylhet,Sylhet,Kanaighat,Paschim Dighirpar,1,1,0,0,0,0,0,1,0
Sylhet,Sylhet,Kanaighat,Bara Chatul,1,1,0,0,0,0,0,0,1
Sylhet,Sylhet,Kanaighat,Kanaighat Paurashava,1,1,0,0,0,0,0,1,0
Sylhet,Sylhet,Kanaighat,Dakshin Banigram,0,0,0,0,0,0,0,0,0
Sylhet,Sylhet,Kanaighat,Kanaighat,0,0,0,0,0,0,0,0,0
Sylhet,Sylhet,Kanaighat,Paschim Lakshmip Rasad,0,0,0,0,0,0,0,0,0
Sylhet,Sylhet,Kanaighat,Purba Lakshmi Prasad,0,0,0,0,0,0,0,0,0
Sylhet,Sylhet,Kanaighat,Rajaganj,0,0,0,0,0,0,0,0,0
Sylhet,Sylhet,Kanaighat,###,5,5,0,0,0,0,0,4,1
Sylhet,Sylhet,Companiganj,Islampur Paschim,3,3,0,0,0,1,0,0,2
Sylhet,Sylhet,Companiganj,Ranikhai Dakshin,1,1,0,0,0,0,0,1,0
Sylhet,Sylhet,Companiganj,Islampur Purba,1,1,0,0,0,0,0,0,1
Sylhet,Sylhet,Companiganj,Ishakalas,0,0,0,0,0,0,0,0,0
Sylhet,Sylhet,Companiganj,Ranikhai Uttar,0,0,0,0,0,0,0,0,0
Sylhet,Sylhet,Companiganj,Telikhal,0,0,0,0,0,0,0,0,0
Sylhet,Sylhet,Companiganj,###,5,5,0,0,0,1,0,1,3
Sylhet,Sylhet,###,###,84,66,18,10,8,5,17,31,13
Sylhet,Habiganj,Ajmiriganj,Shibpasha,4,0,4,0,4,0,0,0,0
Sylhet,Habiganj,Ajmiriganj,Ajmiriganj,1,1,0,0,0,0,0,1,0
Sylhet,Habiganj,Ajmiriganj,Kakailseo,1,1,0,0,0,0,0,0,1
Sylhet,Habiganj,Ajmiriganj,Badalpur,1,1,0,0,0,0,0,0,1
Sylhet,Habiganj,Ajmiriganj,Jalsuka,2,2,0,0,0,0,1,1,0
Sylhet,Habiganj,Ajmiriganj,Ajmiriganj Paurashava,0,0,0,0,0,0,0,0,0
Sylhet,Habiganj,Ajmiriganj,###,9,5,4,0,4,0,1,2,2
Sylhet,Habiganj,Nabiganj,Paniunda,5,1,4,0,4,0,1,0,0
Sylhet,Habiganj,Nabiganj,Debpara,1,1,0,0,0,0,1,0,0
Sylhet,Habiganj,Nabiganj,Auskandi,1,1,0,0,0,0,0,1,0
Sylhet,Habiganj,Nabiganj,Bausha,1,1,0,0,0,0,0,1,0
Sylhet,Habiganj,Nabiganj,Nabiganj,2,1,1,1,0,0,0,0,1
Sylhet,Habiganj,Nabiganj,Kalair Banga,1,1,0,0,0,0,0,1,0
Sylhet,Habiganj,Nabiganj,Kargaon,1,1,0,0,0,0,0,1,0
Sylhet,Habiganj,Nabiganj,Dighalbak,0,0,0,0,0,0,0,0,0
Sylhet,Habiganj,Nabiganj,Gaznapur,0,0,0,0,0,0,0,0,0
Sylhet,Habiganj,Nabiganj,Inathganj,0,0,0,0,0,0,0,0,0
Sylhet,Habiganj,Nabiganj,Kurshi,0,0,0,0,0,0,0,0,0
Sylhet,Habiganj,Nabiganj,Nabiganj Paurashava,0,0,0,0,0,0,0,0,0
Sylhet,Habiganj,Nabiganj,Paschim Bara Bhakhair,0,0,0,0,0,0,0,0,0
Sylhet,Habiganj,Nabiganj,Purba Bara Bakhair,0,0,0,0,0,0,0,0,0
Sylhet,Habiganj,Nabiganj,###,12,7,5,1,4,0,2,4,1
Sylhet,Habiganj,Madhabpur,Jagadishpur,3,1,2,0,2,0,0,1,0
Sylhet,Habiganj,Madhabpur,Madhabpur Paurashava,1,0,1,1,0,0,0,0,0
Sylhet,Habiganj,Madhabpur,Chhatiain,1,1,0,0,0,0,1,0,0
Sylhet,Habiganj,Madhabpur,Bagasura,1,1,0,0,0,0,1,0,0
Sylhet,Habiganj,Madhabpur,Chowmohani,1,1,0,0,0,0,1,0,0
Sylhet,Habiganj,Madhabpur,Andiurauk,1,1,0,0,0,0,1,0,0
Sylhet,Habiganj,Madhabpur,Adair,1,1,0,0,0,0,0,1,0
Sylhet,Habiganj,Madhabpur,Bahara,0,0,0,0,0,0,0,0,0
Sylhet,Habiganj,Madhabpur,Bulla,0,0,0,0,0,0,0,0,0
Sylhet,Habiganj,Madhabpur,Dharmaghar,0,0,0,0,0,0,0,0,0
Sylhet,Habiganj,Madhabpur,Noapara,0,0,0,0,0,0,0,0,0
Sylhet,Habiganj,Madhabpur,Shahjahanpur,0,0,0,0,0,0,0,0,0
Sylhet,Habiganj,Madhabpur,###,9,6,3,1,2,0,4,2,0
Sylhet,Habiganj,Chunarughat,Ubahata,4,2,2,0,2,0,0,1,1
Sylhet,Habiganj,Chunarughat,Deorgachh,1,1,0,0,0,0,0,1,0
Sylhet,Habiganj,Chunarughat,Mirahi,1,1,0,0,0,0,0,1,0
Sylhet,Habiganj,Chunarughat,Paik Para,1,1,0,0,0,0,1,0,0
Sylhet,Habiganj,Chunarughat,Gazipur,1,1,0,0,0,0,0,1,0
Sylhet,Habiganj,Chunarughat,Chunarughat Paurashava,1,1,0,0,0,0,0,0,1
Sylhet,Habiganj,Chunarughat,Shatiajuri,1,1,0,0,0,0,1,0,0
Sylhet,Habiganj,Chunarughat,Ahmadabad,0,0,0,0,0,0,0,0,0
Sylhet,Habiganj,Chunarughat,Chunarughat,0,0,0,0,0,0,0,0,0
Sylhet,Habiganj,Chunarughat,Ranigaon,0,0,0,0,0,0,0,0,0
Sylhet,Habiganj,Chunarughat,Sankhola,0,0,0,0,0,0,0,0,0
Sylhet,Habiganj,Chunarughat,###,10,8,2,0,2,0,2,4,2
Sylhet,Habiganj,Bahubal,Putijuri,2,2,0,0,0,0,0,2,0
Sylhet,Habiganj,Bahubal,Snanghat,1,1,0,0,0,0,0,1,0
Sylhet,Habiganj,Bahubal,Bhadeshwar,1,1,0,0,0,0,1,0,0
Sylhet,Habiganj,Bahubal,Satkapan,1,1,0,0,0,0,0,1,0
Sylhet,Habiganj,Bahubal,Mirpur,1,1,0,0,0,0,0,1,0
Sylhet,Habiganj,Bahubal,Lamatashi,1,1,0,0,0,0,0,1,0
Sylhet,Habiganj,Bahubal,Bahubal,0,0,0,0,0,0,0,0,0
Sylhet,Habiganj,Bahubal,###,7,7,0,0,0,0,1,6,0
Sylhet,Habiganj,Habiganj Sadar,Nurpur,1,1,0,0,0,0,0,1,0
Sylhet,Habiganj,Habiganj Sadar,Lukhra,1,1,0,0,0,0,0,1,0
Sylhet,Habiganj,Habiganj Sadar,Habiganj Paurashava,2,1,1,1,0,0,0,1,0
Sylhet,Habiganj,Habiganj Sadar,Nizampur,2,2,0,0,0,0,1,1,0
Sylhet,Habiganj,Habiganj Sadar,Poil,1,1,0,0,0,0,1,0,0
Sylhet,Habiganj,Habiganj Sadar,Gopaya,0,0,0,0,0,0,0,0,0
Sylhet,Habiganj,Habiganj Sadar,Laskarpur,0,0,0,0,0,0,0,0,0
Sylhet,Habiganj,Habiganj Sadar,Raziura,0,0,0,0,0,0,0,0,0
Sylhet,Habiganj,Habiganj Sadar,Richi,0,0,0,0,0,0,0,0,0
Sylhet,Habiganj,Habiganj Sadar,Saistaganj,0,0,0,0,0,0,0,0,0
Sylhet,Habiganj,Habiganj Sadar,Shayestagang Paurashava,0,0,0,0,0,0,0,0,0
Sylhet,Habiganj,Habiganj Sadar,Tegharia,0,0,0,0,0,0,0,0,0
Sylhet,Habiganj,Habiganj Sadar,###,7,6,1,1,0,0,2,4,0
Sylhet,Habiganj,Lakhai,Muriauk,1,1,0,0,0,0,0,1,0
Sylhet,Habiganj,Lakhai,Karab,2,2,0,0,0,0,0,1,1
Sylhet,Habiganj,Lakhai,Murakari,1,1,0,0,0,0,0,1,0
Sylhet,Habiganj,Lakhai,Bamai,1,1,0,0,0,0,0,1,0
Sylhet,Habiganj,Lakhai,Bulla,0,0,0,0,0,0,0,0,0
Sylhet,Habiganj,Lakhai,Lakhai,0,0,0,0,0,0,0,0,0
Sylhet,Habiganj,Lakhai,###,5,5,0,0,0,0,0,4,1
Sylhet,Habiganj,Baniachong,Uttar Purba Baniachang,2,2,0,0,0,0,1,1,0
Sylhet,Habiganj,Baniachong,Subidpur,4,4,0,0,0,0,0,4,0
Sylhet,Habiganj,Baniachong,Khagaura,1,1,0,0,0,0,0,1,0
Sylhet,Habiganj,Baniachong,Dakshin Purba Baniyachang,3,3,0,0,0,0,1,2,0
Sylhet,Habiganj,Baniachong,Uttar Paschim Baniyachang,1,1,0,0,0,0,1,0,0
Sylhet,Habiganj,Baniachong,Baraiuri,0,0,0,0,0,0,0,0,0
Sylhet,Habiganj,Baniachong,Dakshin Paschim Baniyachang,0,0,0,0,0,0,0,0,0
Sylhet,Habiganj,Baniachong,Daulatpur,0,0,0,0,0,0,0,0,0
Sylhet,Habiganj,Baniachong,Kagapasha,0,0,0,0,0,0,0,0,0
Sylhet,Habiganj,Baniachong,Makrampur,0,0,0,0,0,0,0,0,0
Sylhet,Habiganj,Baniachong,Mandari,0,0,0,0,0,0,0,0,0
Sylhet,Habiganj,Baniachong,Muradpur,0,0,0,0,0,0,0,0,0
Sylhet,Habiganj,Baniachong,Pailarkandi,0,0,0,0,0,0,0,0,0
Sylhet,Habiganj,Baniachong,Pukhra,0,0,0,0,0,0,0,0,0
Sylhet,Habiganj,Baniachong,Sujatpur,0,0,0,0,0,0,0,0,0
Sylhet,Habiganj,Baniachong,###,11,11,0,0,0,0,3,8,0
Sylhet,Habiganj,###,###,70,55,15,3,12,0,15,34,6
Sylhet,Maulvibazar,Maulvi Bazar Sadar,Amtail,3,0,3,1,2,0,0,0,0
Sylhet,Maulvibazar,Maulvi Bazar Sadar,Maulvibazar Paurashava,2,2,0,0,0,0,0,1,1
Sylhet,Maulvibazar,Maulvi Bazar Sadar,Giasnagar,1,1,0,0,0,0,0,1,0
Sylhet,Maulvibazar,Maulvi Bazar Sadar,Chandighat,1,1,0,0,0,0,0,0,1
Sylhet,Maulvibazar,Maulvi Bazar Sadar,Upper Kagabala,1,1,0,0,0,0,1,0,0
Sylhet,Maulvibazar,Maulvi Bazar Sadar,Nazirabad,1,1,0,0,0,0,0,0,1
Sylhet,Maulvibazar,Maulvi Bazar Sadar,Ekatuna,1,1,0,0,0,0,0,0,1
Sylhet,Maulvibazar,Maulvi Bazar Sadar,Manumukh,1,0,1,1,0,0,0,0,0
Sylhet,Maulvibazar,Maulvi Bazar Sadar,Khalilpur,1,0,1,1,0,0,0,0,0
Sylhet,Maulvibazar,Maulvi Bazar Sadar,Akhailkura,0,0,0,0,0,0,0,0,0
Sylhet,Maulvibazar,Maulvi Bazar Sadar,Kamalpur,0,0,0,0,0,0,0,0,0
Sylhet,Maulvibazar,Maulvi Bazar Sadar,Kanakpur,0,0,0,0,0,0,0,0,0
Sylhet,Maulvibazar,Maulvi Bazar Sadar,Mostafapur,0,0,0,0,0,0,0,0,0
Sylhet,Maulvibazar,Maulvi Bazar Sadar,###,12,7,5,3,2,0,1,2,4
Sylhet,Maulvibazar,Kulaura,Prithim Pasha,2,0,2,0,2,0,0,0,0
Sylhet,Maulvibazar,Kulaura,Baramchal,1,1,0,0,0,0,0,1,0
Sylhet,Maulvibazar,Kulaura,Kulaura,2,2,0,0,0,0,1,1,0
Sylhet,Maulvibazar,Kulaura,Hajipur,1,1,0,0,0,0,0,1,0
Sylhet,Maulvibazar,Kulaura,Brahman Bazar,1,1,0,0,0,0,0,1,0
Sylhet,Maulvibazar,Kulaura,Kulaura Paurashava,1,1,0,0,0,0,0,1,0
Sylhet,Maulvibazar,Kulaura,Bhatera,0,0,0,0,0,0,0,0,0
Sylhet,Maulvibazar,Kulaura,Bhukshimail,0,0,0,0,0,0,0,0,0
Sylhet,Maulvibazar,Kulaura,Joychandi,0,0,0,0,0,0,0,0,0
Sylhet,Maulvibazar,Kulaura,Kadirpur,0,0,0,0,0,0,0,0,0
Sylhet,Maulvibazar,Kulaura,Karmadha,0,0,0,0,0,0,0,0,0
Sylhet,Maulvibazar,Kulaura,Routhgaon,0,0,0,0,0,0,0,0,0
Sylhet,Maulvibazar,Kulaura,Sharifpur,0,0,0,0,0,0,0,0,0
Sylhet,Maulvibazar,Kulaura,Tilagaon,0,0,0,0,0,0,0,0,0
Sylhet,Maulvibazar,Kulaura,###,8,6,2,0,2,0,1,5,0
Sylhet,Maulvibazar,Sreemangal,Sreemangal,2,0,2,0,2,0,0,0,0
Sylhet,Maulvibazar,Sreemangal,Kalighat,1,1,0,0,0,0,1,0,0
Sylhet,Maulvibazar,Sreemangal,Sreemangal Paurashava,2,1,1,1,0,0,1,0,0
Sylhet,Maulvibazar,Sreemangal,Rajghat,1,1,0,0,0,0,1,0,0
Sylhet,Maulvibazar,Sreemangal,Sindurkhan,1,1,0,0,0,0,0,1,0
Sylhet,Maulvibazar,Sreemangal,Mirzapur,1,1,0,0,0,0,1,0,0
Sylhet,Maulvibazar,Sreemangal,Kalapur,1,1,0,0,0,0,1,0,0
Sylhet,Maulvibazar,Sreemangal,Bhunabir,1,1,0,0,0,0,0,1,0
Sylhet,Maulvibazar,Sreemangal,Ashidron,0,0,0,0,0,0,0,0,0
Sylhet,Maulvibazar,Sreemangal,Satgoan,0,0,0,0,0,0,0,0,0
Sylhet,Maulvibazar,Sreemangal,###,10,7,3,1,2,0,5,2,0
Sylhet,Maulvibazar,Barlekha,Barni,2,0,2,0,2,0,0,0,0
Sylhet,Maulvibazar,Barlekha,Dasher Bazar,1,1,0,0,0,0,0,1,0
Sylhet,Maulvibazar,Barlekha,Uttar Shahabajpur,1,1,0,0,0,0,1,0,0
Sylhet,Maulvibazar,Barlekha,Dakshin Shahabajpur,1,1,0,0,0,0,1,0,0
Sylhet,Maulvibazar,Barlekha,Barlekha Paurashava,3,1,2,0,2,0,0,1,0
Sylhet,Maulvibazar,Barlekha,Uttar Dakshinbhag,1,1,0,0,0,0,0,0,1
Sylhet,Maulvibazar,Barlekha,Sujanagar,1,1,0,0,0,0,0,1,0
Sylhet,Maulvibazar,Barlekha,Barlekha,0,0,0,0,0,0,0,0,0
Sylhet,Maulvibazar,Barlekha,Dakshin Dakshinbhagh,0,0,0,0,0,0,0,0,0
Sylhet,Maulvibazar,Barlekha,Nij Bahadurpur,0,0,0,0,0,0,0,0,0
Sylhet,Maulvibazar,Barlekha,Talimpur,0,0,0,0,0,0,0,0,0
Sylhet,Maulvibazar,Barlekha,###,10,6,4,0,4,0,2,3,1
Sylhet,Maulvibazar,Kamalganj,Kamalganj,3,1,2,0,2,0,1,0,0
Sylhet,Maulvibazar,Kamalganj,Adampur,2,2,0,0,0,0,0,1,1
Sylhet,Maulvibazar,Kamalganj,Shamshernagar,1,1,0,0,0,0,1,0,0
Sylhet,Maulvibazar,Kamalganj,Madhabpur,1,1,0,0,0,0,1,0,0
Sylhet,Maulvibazar,Kamalganj,Munshi Bazar,2,2,0,0,0,0,1,0,1
Sylhet,Maulvibazar,Kamalganj,Alinagar,1,1,0,0,0,0,1,0,0
Sylhet,Maulvibazar,Kamalganj,Patanushar,1,1,0,0,0,0,0,1,0
Sylhet,Maulvibazar,Kamalganj,Islampur,0,0,0,0,0,0,0,0,0
Sylhet,Maulvibazar,Kamalganj,Kamalganj Paurashava,0,0,0,0,0,0,0,0,0
Sylhet,Maulvibazar,Kamalganj,Rahimpur,0,0,0,0,0,0,0,0,0
Sylhet,Maulvibazar,Kamalganj,###,11,9,2,0,2,0,5,2,2
Sylhet,Maulvibazar,Juri,Jaifarnagar,2,0,2,0,2,0,0,0,0
Sylhet,Maulvibazar,Juri,Fultala,1,1,0,0,0,0,1,0,0
Sylhet,Maulvibazar,Juri,Sagarnal,1,1,0,0,0,0,1,0,0
Sylhet,Maulvibazar,Juri,Goalbari,1,1,0,0,0,0,1,0,0
Sylhet,Maulvibazar,Juri,Purba Juri,1,1,0,0,0,0,0,1,0
Sylhet,Maulvibazar,Juri,Paschim Juri,1,1,0,0,0,0,1,0,0
Sylhet,Maulvibazar,Juri,###,7,5,2,0,2,0,4,1,0
Sylhet,Maulvibazar,Rajnagar,Tengra,1,1,0,0,0,0,0,1,0
Sylhet,Maulvibazar,Rajnagar,Kamar Chak,1,1,0,0,0,0,0,1,0
Sylhet,Maulvibazar,Rajnagar,Mansurnagar,2,2,0,0,0,0,1,1,0
Sylhet,Maulvibazar,Rajnagar,Munshi Bazar,2,2,0,0,0,0,1,1,0
Sylhet,Maulvibazar,Rajnagar,Uttarbhag,1,1,0,0,0,0,0,1,0
Sylhet,Maulvibazar,Rajnagar,Panchgaon,1,1,0,0,0,0,0,1,0
Sylhet,Maulvibazar,Rajnagar,Fatehpur,0,0,0,0,0,0,0,0,0
Sylhet,Maulvibazar,Rajnagar,Rajnagar,0,0,0,0,0,0,0,0,0
Sylhet,Maulvibazar,Rajnagar,###,8,8,0,0,0,0,2,6,0
Sylhet,Maulvibazar,###,###,66,48,18,4,14,0,20,21,7
Sylhet,###,###,###,351,184,167,69,98,7,55,91,31
Mymensingh,Netrakona,Kendua,Balaishimul,3,1,2,0,2,0,0,1,0
Mymensingh,Netrakona,Kendua,Roailbari,1,1,0,0,0,0,0,0,1
Mymensingh,Netrakona,Kendua,Sandikona,1,1,0,0,0,0,0,0,1
Mymensingh,Netrakona,Kendua,Garadoba,1,1,0,0,0,0,0,0,1
Mymensingh,Netrakona,Kendua,Asujia,1,1,0,0,0,0,0,1,0
Mymensingh,Netrakona,Kendua,Mashka,1,1,0,0,0,0,0,1,0
Mymensingh,Netrakona,Kendua,Kendua Paurashava,1,1,0,0,0,0,1,0,0
Mymensingh,Netrakona,Kendua,Chirang,1,1,0,0,0,0,1,0,0
Mymensingh,Netrakona,Kendua,Dalpa,0,0,0,0,0,0,0,0,0
Mymensingh,Netrakona,Kendua,Ganda,0,0,0,0,0,0,0,0,0
Mymensingh,Netrakona,Kendua,Kandiura,0,0,0,0,0,0,0,0,0
Mymensingh,Netrakona,Kendua,Muzaffarpur,0,0,0,0,0,0,0,0,0
Mymensingh,Netrakona,Kendua,Noapara,0,0,0,0,0,0,0,0,0
Mymensingh,Netrakona,Kendua,Paikura,0,0,0,0,0,0,0,0,0
Mymensingh,Netrakona,Kendua,###,10,8,2,0,2,0,2,3,3
Mymensingh,Netrakona,Barhatta,Barhatta,2,2,0,0,0,0,1,0,1
Mymensingh,Netrakona,Barhatta,Sahata,1,1,0,0,0,0,0,0,1
Mymensingh,Netrakona,Barhatta,Singdha,1,1,0,0,0,0,0,0,1
Mymensingh,Netrakona,Barhatta,Asma,1,1,0,0,0,0,0,0,1
Mymensingh,Netrakona,Barhatta,Roypur,1,1,0,0,0,0,0,0,1
Mymensingh,Netrakona,Barhatta,Chhiram,1,1,0,0,0,0,0,0,1
Mymensingh,Netrakona,Barhatta,Baushi,1,1,0,0,0,0,0,0,1
Mymensingh,Netrakona,Barhatta,###,8,8,0,0,0,0,1,0,7
Mymensingh,Netrakona,Purbadhala,Agia,1,1,0,0,0,0,0,0,1
Mymensingh,Netrakona,Purbadhala,Narandia,2,2,0,0,0,0,0,1,1
Mymensingh,Netrakona,Purbadhala,Purbadhala Paurashava,1,1,0,0,0,0,0,0,1
Mymensingh,Netrakona,Purbadhala,Hogla,1,1,0,0,0,0,0,0,1
Mymensingh,Netrakona,Purbadhala,Jaria,1,1,0,0,0,0,0,0,1
Mymensingh,Netrakona,Purbadhala,Dhala Mulgaon,1,1,0,0,0,0,0,1,0
Mymensingh,Netrakona,Purbadhala,Bairati,0,0,0,0,0,0,0,0,0
Mymensingh,Netrakona,Purbadhala,Bishkakuni,0,0,0,0,0,0,0,0,0
Mymensingh,Netrakona,Purbadhala,Ghagra,0,0,0,0,0,0,0,0,0
Mymensingh,Netrakona,Purbadhala,Gohalakanda,0,0,0,0,0,0,0,0,0
Mymensingh,Netrakona,Purbadhala,Khalishaur,0,0,0,0,0,0,0,0,0
Mymensingh,Netrakona,Purbadhala,Purbadhala,0,0,0,0,0,0,0,0,0
Mymensingh,Netrakona,Purbadhala,###,7,7,0,0,0,0,0,2,5
Mymensingh,Netrakona,Netrokona Sadar,Kailati,1,1,0,0,0,0,0,0,1
Mymensingh,Netrakona,Netrokona Sadar,Thakurakona,1,1,0,0,0,0,0,0,1
Mymensingh,Netrakona,Netrokona Sadar,Dakshin Bishiura,1,1,0,0,0,0,0,0,1
Mymensingh,Netrakona,Netrokona Sadar,Amtala,1,1,0,0,0,0,0,0,1
Mymensingh,Netrakona,Netrokona Sadar,Rauha,1,1,0,0,0,0,0,0,1
Mymensingh,Netrakona,Netrokona Sadar,Madanpur,1,1,0,0,0,0,0,1,0
Mymensingh,Netrakona,Netrokona Sadar,Netrokona Paurashava,3,1,2,0,2,0,0,1,0
Mymensingh,Netrakona,Netrokona Sadar,Maugati,1,1,0,0,0,0,0,1,0
Mymensingh,Netrakona,Netrokona Sadar,Challisha,0,0,0,0,0,0,0,0,0
Mymensingh,Netrakona,Netrokona Sadar,Kaliara Gabragat,0,0,0,0,0,0,0,0,0
Mymensingh,Netrakona,Netrokona Sadar,Lakshmiganj,0,0,0,0,0,0,0,0,0
Mymensingh,Netrakona,Netrokona Sadar,Medni,0,0,0,0,0,0,0,0,0
Mymensingh,Netrakona,Netrokona Sadar,Singhar Bangla,0,0,0,0,0,0,0,0,0
Mymensingh,Netrakona,Netrokona Sadar,###,10,8,2,0,2,0,0,3,5
Mymensingh,Netrakona,Atpara,Sonai,3,3,0,0,0,0,0,1,2
Mymensingh,Netrakona,Atpara,Duaz,1,1,0,0,0,0,0,0,1
Mymensingh,Netrakona,Atpara,Teligati,1,1,0,0,0,0,0,1,0
Mymensingh,Netrakona,Atpara,Sarmaisa,1,1,0,0,0,0,0,0,1
Mymensingh,Netrakona,Atpara,Sukhari,1,0,1,1,0,0,0,0,0
Mymensingh,Netrakona,Atpara,Baniajan,0,0,0,0,0,0,0,0,0
Mymensingh,Netrakona,Atpara,Loneshwar,0,0,0,0,0,0,0,0,0
Mymensingh,Netrakona,Atpara,###,7,6,1,1,0,0,0,2,4
Mymensingh,Netrakona,Mohanganj,Baratali Banihari,4,1,3,1,2,0,0,0,1
Mymensingh,Netrakona,Mohanganj,Maghan Siadhar,1,1,0,0,0,0,0,0,1
Mymensingh,Netrakona,Mohanganj,Samaj Sahildeo,1,1,0,0,0,0,0,0,1
Mymensingh,Netrakona,Mohanganj,Suair,1,0,1,1,0,0,0,0,0
Mymensingh,Netrakona,Mohanganj,Mohanganj Paurashava,2,1,1,1,0,0,1,0,0
Mymensingh,Netrakona,Mohanganj,Barkashia Biramp,1,0,1,1,0,0,0,0,0
Mymensingh,Netrakona,Mohanganj,Gaglajur,1,0,1,1,0,0,0,0,0
Mymensingh,Netrakona,Mohanganj,Tentulia,1,0,1,1,0,0,0,0,0
Mymensingh,Netrakona,Mohanganj,###,12,4,8,6,2,0,1,0,3
Mymensingh,Netrakona,Madan,Kaitail,1,1,0,0,0,0,0,0,1
Mymensingh,Netrakona,Madan,Madan Paurashava,1,1,0,0,0,0,0,0,1
Mymensingh,Netrakona,Madan,Fatehpur,1,1,0,0,0,0,0,0,1
Mymensingh,Netrakona,Madan,Chandgaon,1,1,0,0,0,0,0,0,1
Mymensingh,Netrakona,Madan,Gobindasree,1,1,0,0,0,0,0,0,1
Mymensingh,Netrakona,Madan,Tiasree,1,1,0,0,0,0,0,0,1
Mymensingh,Netrakona,Madan,Madan,1,1,0,0,0,0,0,0,1
Mymensingh,Netrakona,Madan,Maghan,0,0,0,0,0,0,0,0,0
Mymensingh,Netrakona,Madan,Nayekpur,0,0,0,0,0,0,0,0,0
Mymensingh,Netrakona,Madan,###,7,7,0,0,0,0,0,0,7
Mymensingh,Netrakona,Durgapur,Durgapur Paurashava,1,1,0,0,0,1,0,0,0
Mymensingh,Netrakona,Durgapur,Birisiri,2,2,0,0,0,0,0,2,0
Mymensingh,Netrakona,Durgapur,Kullagora,1,1,0,0,0,0,1,0,0
Mymensingh,Netrakona,Durgapur,Chandigarh,2,2,0,0,0,0,1,0,1
Mymensingh,Netrakona,Durgapur,Kakairgara,1,1,0,0,0,0,0,0,1
Mymensingh,Netrakona,Durgapur,Bakaljora,0,0,0,0,0,0,0,0,0
Mymensingh,Netrakona,Durgapur,Durgapur,0,0,0,0,0,0,0,0,0
Mymensingh,Netrakona,Durgapur,Gaokandia,0,0,0,0,0,0,0,0,0
Mymensingh,Netrakona,Durgapur,###,7,7,0,0,0,1,2,2,2
Mymensingh,Netrakona,Kalmakanda,Kailati,1,1,0,0,0,0,0,0,1
Mymensingh,Netrakona,Kalmakanda,Bara Kharpan,2,2,0,0,0,0,0,0,2
Mymensingh,Netrakona,Kalmakanda,Pogla,1,1,0,0,0,0,0,0,1
Mymensingh,Netrakona,Kalmakanda,Lengura,1,1,0,0,0,0,1,0,0
Mymensingh,Netrakona,Kalmakanda,Kharnai,1,1,0,0,0,0,0,0,1
Mymensingh,Netrakona,Kalmakanda,Kalmakanda,2,0,2,2,0,0,0,0,0
Mymensingh,Netrakona,Kalmakanda,Nazirpur,0,0,0,0,0,0,0,0,0
Mymensingh,Netrakona,Kalmakanda,Rangchhati,0,0,0,0,0,0,0,0,0
Mymensingh,Netrakona,Kalmakanda,###,8,6,2,2,0,0,1,0,5
Mymensingh,Netrakona,Khaliajuri,Krishnapur,1,0,1,1,0,0,0,0,0
Mymensingh,Netrakona,Khaliajuri,Gazipur,2,2,0,0,0,0,0,0,2
Mymensingh,Netrakona,Khaliajuri,Khaliajuri,2,1,1,1,0,1,0,0,0
Mymensingh,Netrakona,Khaliajuri,Mendipur,2,2,0,0,0,0,0,0,2
Mymensingh,Netrakona,Khaliajuri,Chakua,0,0,0,0,0,0,0,0,0
Mymensingh,Netrakona,Khaliajuri,Nagar,0,0,0,0,0,0,0,0,0
Mymensingh,Netrakona,Khaliajuri,###,7,5,2,2,0,1,0,0,4
Mymensingh,Netrakona,###,###,83,66,17,11,6,2,7,12,45
Mymensingh,Mymensingh,Haluaghat,Haluaghat,4,2,2,0,2,0,1,0,1
Mymensingh,Mymensingh,Haluaghat,Dhara,1,1,0,0,0,0,0,1,0
Mymensingh,Mymensingh,Haluaghat,Swadeshi,1,1,0,0,0,0,0,0,1
Mymensingh,Mymensingh,Haluaghat,Dhurail,2,2,0,0,0,1,0,1,0
Mymensingh,Mymensingh,Haluaghat,Gazir Bhita,2,2,0,0,0,0,1,0,1
Mymensingh,Mymensingh,Haluaghat,Bhubankura,1,1,0,0,0,0,1,0,0
Mymensingh,Mymensingh,Haluaghat,Amtail,0,0,0,0,0,0,0,0,0
Mymensingh,Mymensingh,Haluaghat,Bildora,0,0,0,0,0,0,0,0,0
Mymensingh,Mymensingh,Haluaghat,Jugli,0,0,0,0,0,0,0,0,0
Mymensingh,Mymensingh,Haluaghat,Kaichapur,0,0,0,0,0,0,0,0,0
Mymensingh,Mymensingh,Haluaghat,Narail,0,0,0,0,0,0,0,0,0
Mymensingh,Mymensingh,Haluaghat,Sakuai,0,0,0,0,0,0,0,0,0
Mymensingh,Mymensingh,Haluaghat,###,11,9,2,0,2,1,3,2,3
Mymensingh,Mymensingh,Gauripur,Bokainagar,3,1,2,0,2,0,1,0,0
Mymensingh,Mymensingh,Gauripur,Ramgopalpur,1,1,0,0,0,0,0,0,1
Mymensingh,Mymensingh,Gauripur,Mailakanda,2,2,0,0,0,0,0,1,1
Mymensingh,Mymensingh,Gauripur,Gauripur Paurashava,1,1,0,0,0,0,0,0,1
Mymensingh,Mymensingh,Gauripur,Dowhakhala,1,1,0,0,0,0,0,1,0
Mymensingh,Mymensingh,Gauripur,Maoha,1,1,0,0,0,0,0,1,0
Mymensingh,Mymensingh,Gauripur,Gauripur,1,1,0,0,0,0,1,0,0
Mymensingh,Mymensingh,Gauripur,Achintapur,1,1,0,0,0,0,1,0,0
Mymensingh,Mymensingh,Gauripur,Bhangnamari,0,0,0,0,0,0,0,0,0
Mymensingh,Mymensingh,Gauripur,Sahanati,0,0,0,0,0,0,0,0,0
Mymensingh,Mymensingh,Gauripur,Sidhla,0,0,0,0,0,0,0,0,0
Mymensingh,Mymensingh,Gauripur,###,11,9,2,0,2,0,3,3,3
Mymensingh,Mymensingh,Mymensingh Sadar,Mymensingh Paurashava,2,1,1,1,0,0,0,1,0
Mymensingh,Mymensingh,Mymensingh Sadar,Bhabkhali,1,1,0,0,0,0,0,0,1
Mymensingh,Mymensingh,Mymensingh Sadar,Dapunia,1,1,0,0,0,0,0,1,0
Mymensingh,Mymensingh,Mymensingh Sadar,Akua,1,1,0,0,0,0,0,1,0
Mymensingh,Mymensingh,Mymensingh Sadar,Paranganj,1,1,0,0,0,0,0,1,0
Mymensingh,Mymensingh,Mymensingh Sadar,Ghagra,1,1,0,0,0,0,0,1,0
Mymensingh,Mymensingh,Mymensingh Sadar,Char Nilakshmia,1,1,0,0,0,0,0,1,0
Mymensingh,Mymensingh,Mymensingh Sadar,Sirta,1,1,0,0,0,0,0,1,0
Mymensingh,Mymensingh,Mymensingh Sadar,Char Ishwardia,1,1,0,0,0,0,1,0,0
Mymensingh,Mymensingh,Mymensingh Sadar,Ashtadhar,0,0,0,0,0,0,0,0,0
Mymensingh,Mymensingh,Mymensingh Sadar,Baira (kewatkhali),0,0,0,0,0,0,0,0,0
Mymensingh,Mymensingh,Mymensingh Sadar,Borar Char,0,0,0,0,0,0,0,0,0
Mymensingh,Mymensingh,Mymensingh Sadar,Khagdahar,0,0,0,0,0,0,0,0,0
Mymensingh,Mymensingh,Mymensingh Sadar,Kushtia,0,0,0,0,0,0,0,0,0
Mymensingh,Mymensingh,Mymensingh Sadar,###,10,9,1,1,0,0,1,7,1
Mymensingh,Mymensingh,Bhaluka,Birunia,2,1,1,1,0,0,0,0,1
Mymensingh,Mymensingh,Bhaluka,Bhaluka,1,1,0,0,0,0,0,0,1
Mymensingh,Mymensingh,Bhaluka,Bhaluka Paurashava,1,1,0,0,0,0,0,0,1
Mymensingh,Mymensingh,Bhaluka,Uthura,1,1,0,0,0,0,0,0,1
Mymensingh,Mymensingh,Bhaluka,Habirbari,1,1,0,0,0,0,0,0,1
Mymensingh,Mymensingh,Bhaluka,Dhitpur,1,1,0,0,0,0,0,1,0
Mymensingh,Mymensingh,Bhaluka,Mallikbari,1,1,0,0,0,0,0,1,0
Mymensingh,Mymensingh,Bhaluka,Meduary,1,1,0,0,0,0,0,1,0
Mymensingh,Mymensingh,Bhaluka,Kachina,1,1,0,0,0,0,0,1,0
Mymensingh,Mymensingh,Bhaluka,Bharadoba,0,0,0,0,0,0,0,0,0
Mymensingh,Mymensingh,Bhaluka,Dakatia,0,0,0,0,0,0,0,0,0
Mymensingh,Mymensingh,Bhaluka,Rajai,0,0,0,0,0,0,0,0,0
Mymensingh,Mymensingh,Bhaluka,###,10,9,1,1,0,0,0,4,5
Mymensingh,Mymensingh,Gaffargaon,Datter Bazar,1,1,0,0,0,0,0,0,1
Mymensingh,Mymensingh,Gaffargaon,Raona,1,1,0,0,0,0,0,1,0
Mymensingh,Mymensingh,Gaffargaon,Langair,3,3,0,0,0,0,0,1,2
Mymensingh,Mymensingh,Gaffargaon,Gaffargaon Paurashava,1,1,0,0,0,0,0,1,0
Mymensingh,Mymensingh,Gaffargaon,Gaffargaon,2,1,1,1,0,0,0,1,0
Mymensingh,Mymensingh,Gaffargaon,Tengaba,1,1,0,0,0,0,0,1,0
Mymensingh,Mymensingh,Gaffargaon,Barabaria,0,0,0,0,0,0,0,0,0
Mymensingh,Mymensingh,Gaffargaon,Char Algi,0,0,0,0,0,0,0,0,0
Mymensingh,Mymensingh,Gaffargaon,Jessora,0,0,0,0,0,0,0,0,0
Mymensingh,Mymensingh,Gaffargaon,Mashakhali,0,0,0,0,0,0,0,0,0
Mymensingh,Mymensingh,Gaffargaon,Nigair,0,0,0,0,0,0,0,0,0
Mymensingh,Mymensingh,Gaffargaon,Paithal,0,0,0,0,0,0,0,0,0
Mymensingh,Mymensingh,Gaffargaon,Panchbhag,0,0,0,0,0,0,0,0,0
Mymensingh,Mymensingh,Gaffargaon,Rasulpur,0,0,0,0,0,0,0,0,0
Mymensingh,Mymensingh,Gaffargaon,Saltia,0,0,0,0,0,0,0,0,0
Mymensingh,Mymensingh,Gaffargaon,Usthi,0,0,0,0,0,0,0,0,0
Mymensingh,Mymensingh,Gaffargaon,###,9,8,1,1,0,0,0,5,3
Mymensingh,Mymensingh,Ishwarganj,Rajibpur,1,1,0,0,0,0,0,0,1
Mymensingh,Mymensingh,Ishwarganj,Uchakhila,1,1,0,0,0,0,0,0,1
Mymensingh,Mymensingh,Ishwarganj,Maijbagh,1,1,0,0,0,0,0,0,1
Mymensingh,Mymensingh,Ishwarganj,Sohagi,1,1,0,0,0,0,0,1,0
Mymensingh,Mymensingh,Ishwarganj,Ishwarganj Paurashava,1,1,0,0,0,0,1,0,0
Mymensingh,Mymensingh,Ishwarganj,Magtala,1,1,0,0,0,0,1,0,0
Mymensingh,Mymensingh,Ishwarganj,Atharabari,2,1,1,1,0,1,0,0,0
Mymensingh,Mymensingh,Ishwarganj,Tarundia,1,1,0,0,0,0,0,0,1
Mymensingh,Mymensingh,Ishwarganj,Barahit,0,0,0,0,0,0,0,0,0
Mymensingh,Mymensingh,Ishwarganj,Ishwarganj,0,0,0,0,0,0,0,0,0
Mymensingh,Mymensingh,Ishwarganj,Jatia,0,0,0,0,0,0,0,0,0
Mymensingh,Mymensingh,Ishwarganj,Sarisha,0,0,0,0,0,0,0,0,0
Mymensingh,Mymensingh,Ishwarganj,###,9,8,1,1,0,1,2,1,4
Mymensingh,Mymensingh,Nandail,Betagair,2,2,0,0,0,0,0,1,1
Mymensingh,Mymensingh,Nandail,Rajgati,1,1,0,0,0,0,0,1,0
Mymensingh,Mymensingh,Nandail,Nandail,2,1,1,1,0,1,0,0,0
Mymensingh,Mymensingh,Nandail,Moazzempur,1,1,0,0,0,0,0,0,1
Mymensingh,Mymensingh,Nandail,Musuli,1,1,0,0,0,0,0,0,1
Mymensingh,Mymensingh,Nandail,Gangail,1,1,0,0,0,0,0,0,1
Mymensingh,Mymensingh,Nandail,Chandipasha,1,0,1,1,0,0,0,0,0
Mymensingh,Mymensingh,Nandail,Singrail,1,1,0,0,0,0,0,1,0
Mymensingh,Mymensingh,Nandail,Achargaon,0,0,0,0,0,0,0,0,0
Mymensingh,Mymensingh,Nandail,Jahangirpur,0,0,0,0,0,0,0,0,0
Mymensingh,Mymensingh,Nandail,Kharua,0,0,0,0,0,0,0,0,0
Mymensingh,Mymensingh,Nandail,Nandail Paurashava,0,0,0,0,0,0,0,0,0
Mymensingh,Mymensingh,Nandail,Sherpur,0,0,0,0,0,0,0,0,0
Mymensingh,Mymensingh,Nandail,###,10,8,2,2,0,1,0,3,4
Mymensingh,Mymensingh,Muktagachha,Kheruajani,1,1,0,0,0,0,0,0,1
Mymensingh,Mymensingh,Muktagachha,Daogaon,1,1,0,0,0,0,0,1,0
Mymensingh,Mymensingh,Muktagachha,Dulla,1,1,0,0,0,0,0,1,0
Mymensingh,Mymensingh,Muktagachha,Mankon,1,1,0,0,0,0,0,1,0
Mymensingh,Mymensingh,Muktagachha,Ghoga,1,1,0,0,0,0,0,1,0
Mymensingh,Mymensingh,Muktagachha,Muktagachha Paurashava,3,2,1,1,0,1,0,1,0
Mymensingh,Mymensingh,Muktagachha,Kashimpur,1,1,0,0,0,0,0,1,0
Mymensingh,Mymensingh,Muktagachha,Baragram,0,0,0,0,0,0,0,0,0
Mymensingh,Mymensingh,Muktagachha,Basati,0,0,0,0,0,0,0,0,0
Mymensingh,Mymensingh,Muktagachha,Kumarghata,0,0,0,0,0,0,0,0,0
Mymensingh,Mymensingh,Muktagachha,Tarati,0,0,0,0,0,0,0,0,0
Mymensingh,Mymensingh,Muktagachha,###,9,8,1,1,0,1,0,6,1
Mymensingh,Mymensingh,Trishal,Kanihari,1,1,0,0,0,0,0,1,0
Mymensingh,Mymensingh,Trishal,Rampur,2,1,1,1,0,0,0,1,0
Mymensingh,Mymensingh,Trishal,Mathbari,1,1,0,0,0,0,0,1,0
Mymensingh,Mymensingh,Trishal,Kanthal,1,1,0,0,0,0,0,1,0
Mymensingh,Mymensingh,Trishal,Bailar,1,1,0,0,0,0,0,1,0
Mymensingh,Mymensingh,Trishal,Mokshapur,1,1,0,0,0,0,0,1,0
Mymensingh,Mymensingh,Trishal,Amirabari,0,0,0,0,0,0,0,0,0
Mymensingh,Mymensingh,Trishal,Bali Para,0,0,0,0,0,0,0,0,0
Mymensingh,Mymensingh,Trishal,Dhanikhola,0,0,0,0,0,0,0,0,0
Mymensingh,Mymensingh,Trishal,Harirampur,0,0,0,0,0,0,0,0,0
Mymensingh,Mymensingh,Trishal,Sakhua,0,0,0,0,0,0,0,0,0
Mymensingh,Mymensingh,Trishal,Trishal,0,0,0,0,0,0,0,0,0
Mymensingh,Mymensingh,Trishal,Trishal Paurashava,0,0,0,0,0,0,0,0,0
Mymensingh,Mymensingh,Trishal,###,7,6,1,1,0,0,0,6,0
Mymensingh,Mymensingh,Fulbaria,Balian,1,1,0,0,0,0,0,1,0
Mymensingh,Mymensingh,Fulbaria,Achim Patuli,1,1,0,0,0,0,0,1,0
Mymensingh,Mymensingh,Fulbaria,Radhakanai,1,1,0,0,0,0,0,1,0
Mymensingh,Mymensingh,Fulbaria,Putijana,1,1,0,0,0,0,0,1,0
Mymensingh,Mymensingh,Fulbaria,Bakta,1,1,0,0,0,0,0,1,0
Mymensingh,Mymensingh,Fulbaria,Naogaon,1,1,0,0,0,0,0,1,0
Mymensingh,Mymensingh,Fulbaria,Fulbaria Paurashava,1,1,0,0,0,0,0,1,0
Mymensingh,Mymensingh,Fulbaria,Deokhola,1,1,0,0,0,0,0,1,0
Mymensingh,Mymensingh,Fulbaria,Bhabanipur,0,0,0,0,0,0,0,0,0
Mymensingh,Mymensingh,Fulbaria,Enayetpur,0,0,0,0,0,0,0,0,0
Mymensingh,Mymensingh,Fulbaria,Fulbaria,0,0,0,0,0,0,0,0,0
Mymensingh,Mymensingh,Fulbaria,Kaladaha,0,0,0,0,0,0,0,0,0
Mymensingh,Mymensingh,Fulbaria,Kushmail,0,0,0,0,0,0,0,0,0
Mymensingh,Mymensingh,Fulbaria,Rangamatia,0,0,0,0,0,0,0,0,0
Mymensingh,Mymensingh,Fulbaria,###,8,8,0,0,0,0,0,8,0
Mymensingh,Mymensingh,Phulpur,Tarakanda,1,1,0,0,0,0,0,1,0
Mymensingh,Mymensingh,Phulpur,Galagaon,1,1,0,0,0,0,0,1,0
Mymensingh,Mymensingh,Phulpur,Sandhara,1,1,0,0,0,0,0,1,0
Mymensingh,Mymensingh,Phulpur,Phulpur Paurashava,2,2,0,0,0,0,0,2,0
Mymensingh,Mymensingh,Phulpur,Baola,1,1,0,0,0,0,0,1,0
Mymensingh,Mymensingh,Phulpur,Kamaria,1,1,0,0,0,0,0,1,0
Mymensingh,Mymensingh,Phulpur,Rahimganj,1,1,0,0,0,0,0,1,0
Mymensingh,Mymensingh,Phulpur,Kamargaon,1,1,0,0,0,0,0,1,0
Mymensingh,Mymensingh,Phulpur,Balia,0,0,0,0,0,0,0,0,0
Mymensingh,Mymensingh,Phulpur,Balikhan,0,0,0,0,0,0,0,0,0
Mymensingh,Mymensingh,Phulpur,Banihala,0,0,0,0,0,0,0,0,0
Mymensingh,Mymensingh,Phulpur,Bhaitkandi,0,0,0,0,0,0,0,0,0
Mymensingh,Mymensingh,Phulpur,Bishka,0,0,0,0,0,0,0,0,0
Mymensingh,Mymensingh,Phulpur,Dhakua,0,0,0,0,0,0,0,0,0
Mymensingh,Mymensingh,Phulpur,Kakni,0,0,0,0,0,0,0,0,0
Mymensingh,Mymensingh,Phulpur,Payari,0,0,0,0,0,0,0,0,0
Mymensingh,Mymensingh,Phulpur,Phulpur,0,0,0,0,0,0,0,0,0
Mymensingh,Mymensingh,Phulpur,Rambhadrapur,0,0,0,0,0,0,0,0,0
Mymensingh,Mymensingh,Phulpur,Rampur,0,0,0,0,0,0,0,0,0
Mymensingh,Mymensingh,Phulpur,Rupasi,0,0,0,0,0,0,0,0,0
Mymensingh,Mymensingh,Phulpur,Singheshwar,0,0,0,0,0,0,0,0,0
Mymensingh,Mymensingh,Phulpur,###,9,9,0,0,0,0,0,9,0
Mymensingh,Mymensingh,Dhobaura,Baghber,4,4,0,0,0,0,0,2,2
Mymensingh,Mymensingh,Dhobaura,Ghoshgaon,2,2,0,0,0,0,0,1,1
Mymensingh,Mymensingh,Dhobaura,Dobaura,1,1,0,0,0,0,0,0,1
Mymensingh,Mymensingh,Dhobaura,Dakshin Maij Para,2,2,0,0,0,0,0,2,0
Mymensingh,Mymensingh,Dhobaura,Gamaritala,0,0,0,0,0,0,0,0,0
Mymensingh,Mymensingh,Dhobaura,Guatala,0,0,0,0,0,0,0,0,0
Mymensingh,Mymensingh,Dhobaura,Pora Kandulia,0,0,0,0,0,0,0,0,0
Mymensingh,Mymensingh,Dhobaura,###,9,9,0,0,0,0,0,5,4
Mymensingh,Mymensingh,###,###,112,100,12,8,4,4,9,59,28
Mymensingh,Jamalpur,Jamalpur Sadar,Sahabajpur,2,2,0,0,0,0,1,1,0
Mymensingh,Jamalpur,Jamalpur Sadar,Lakshmir Char,1,1,0,0,0,0,1,0,0
Mymensingh,Jamalpur,Jamalpur Sadar,Ranagachha,1,1,0,0,0,0,1,0,0
Mymensingh,Jamalpur,Jamalpur Sadar,Titpalla,1,1,0,0,0,0,1,0,0
Mymensingh,Jamalpur,Jamalpur Sadar,Jamalpur Paurashava,1,1,0,0,0,0,1,0,0
Mymensingh,Jamalpur,Jamalpur Sadar,Sharifpur,1,1,0,0,0,0,1,0,0
Mymensingh,Jamalpur,Jamalpur Sadar,Ghoradhap,1,1,0,0,0,0,1,0,0
Mymensingh,Jamalpur,Jamalpur Sadar,Digpaith,1,1,0,0,0,0,1,0,0
Mymensingh,Jamalpur,Jamalpur Sadar,Kendua,1,1,0,0,0,0,1,0,0
Mymensingh,Jamalpur,Jamalpur Sadar,Meshta,2,2,0,0,0,0,2,0,0
Mymensingh,Jamalpur,Jamalpur Sadar,Banshchara,0,0,0,0,0,0,0,0,0
Mymensingh,Jamalpur,Jamalpur Sadar,Itail,0,0,0,0,0,0,0,0,0
Mymensingh,Jamalpur,Jamalpur Sadar,Narundi,0,0,0,0,0,0,0,0,0
Mymensingh,Jamalpur,Jamalpur Sadar,Rashidpur,0,0,0,0,0,0,0,0,0
Mymensingh,Jamalpur,Jamalpur Sadar,Sreepur,0,0,0,0,0,0,0,0,0
Mymensingh,Jamalpur,Jamalpur Sadar,Tulsir Char,0,0,0,0,0,0,0,0,0
Mymensingh,Jamalpur,Jamalpur Sadar,###,12,12,0,0,0,0,11,1,0
Mymensingh,Jamalpur,Islampur,Goaler Char,1,1,0,0,0,0,1,0,0
Mymensingh,Jamalpur,Islampur,Islampur Paurashava,3,3,0,0,0,1,2,0,0
Mymensingh,Jamalpur,Islampur,Chinadulli,1,1,0,0,0,0,1,0,0
Mymensingh,Jamalpur,Islampur,Patharsi,1,1,0,0,0,0,1,0,0
Mymensingh,Jamalpur,Islampur,Kulkandi,1,1,0,0,0,0,1,0,0
Mymensingh,Jamalpur,Islampur,Noarpara,1,1,0,0,0,0,1,0,0
Mymensingh,Jamalpur,Islampur,Belgachha,0,0,0,0,0,0,0,0,0
Mymensingh,Jamalpur,Islampur,Char Goalini,0,0,0,0,0,0,0,0,0
Mymensingh,Jamalpur,Islampur,Char Putimari,0,0,0,0,0,0,0,0,0
Mymensingh,Jamalpur,Islampur,Gaibandha,0,0,0,0,0,0,0,0,0
Mymensingh,Jamalpur,Islampur,Islampur,0,0,0,0,0,0,0,0,0
Mymensingh,Jamalpur,Islampur,Palbandha,0,0,0,0,0,0,0,0,0
Mymensingh,Jamalpur,Islampur,Sapdhari,0,0,0,0,0,0,0,0,0
Mymensingh,Jamalpur,Islampur,###,8,8,0,0,0,1,7,0,0
Mymensingh,Jamalpur,Madarganj,Char Pakerdaha,1,1,0,0,0,0,1,0,0
Mymensingh,Jamalpur,Madarganj,Sidhuli,2,2,0,0,0,0,2,0,0
Mymensingh,Jamalpur,Madarganj,Gunaritala,1,1,0,0,0,0,1,0,0
Mymensingh,Jamalpur,Madarganj,Madarganj Paurashava,2,2,0,0,0,1,1,0,0
Mymensingh,Jamalpur,Madarganj,Jorekhali,1,1,0,0,0,0,1,0,0
Mymensingh,Jamalpur,Madarganj,Karaichara,1,1,0,0,0,0,1,0,0
Mymensingh,Jamalpur,Madarganj,Adarbhita,1,1,0,0,0,0,1,0,0
Mymensingh,Jamalpur,Madarganj,Balijuri,0,0,0,0,0,0,0,0,0
Mymensingh,Jamalpur,Madarganj,###,9,9,0,0,0,1,8,0,0
Mymensingh,Jamalpur,Melandaha,Mahmudpur,1,1,0,0,0,0,1,0,0
Mymensingh,Jamalpur,Melandaha,Fulkocha,1,1,0,0,0,1,0,0,0
Mymensingh,Jamalpur,Melandaha,Char Banipakuri,1,1,0,0,0,1,0,0,0
Mymensingh,Jamalpur,Melandaha,Kulia,1,1,0,0,0,0,1,0,0
Mymensingh,Jamalpur,Melandaha,Melandaha Paurashava,3,3,0,0,0,0,3,0,0
Mymensingh,Jamalpur,Melandaha,Durmut,1,1,0,0,0,0,1,0,0
Mymensingh,Jamalpur,Melandaha,Shaympur,1,1,0,0,0,0,1,0,0
Mymensingh,Jamalpur,Melandaha,Jhaugara,1,1,0,0,0,0,1,0,0
Mymensingh,Jamalpur,Melandaha,Nayanagar,1,1,0,0,0,0,1,0,0
Mymensingh,Jamalpur,Melandaha,Adra,1,1,0,0,0,0,1,0,0
Mymensingh,Jamalpur,Melandaha,Ghosher Para,0,0,0,0,0,0,0,0,0
Mymensingh,Jamalpur,Melandaha,Nangla,0,0,0,0,0,0,0,0,0
Mymensingh,Jamalpur,Melandaha,###,12,12,0,0,0,2,10,0,0
Mymensingh,Jamalpur,Bakshiganj,Bakshiganj,2,2,0,0,0,0,2,0,0
Mymensingh,Jamalpur,Bakshiganj,Bagar Char,2,2,0,0,0,1,1,0,0
Mymensingh,Jamalpur,Bakshiganj,Merur Char,1,1,0,0,0,0,1,0,0
Mymensingh,Jamalpur,Bakshiganj,Sadhur Para,1,1,0,0,0,0,1,0,0
Mymensingh,Jamalpur,Bakshiganj,Dhanua,1,1,0,0,0,0,1,0,0
Mymensingh,Jamalpur,Bakshiganj,Nilakshmia,1,1,0,0,0,0,1,0,0
Mymensingh,Jamalpur,Bakshiganj,Battajore,1,1,0,0,0,0,1,0,0
Mymensingh,Jamalpur,Bakshiganj,###,9,9,0,0,0,1,8,0,0
Mymensingh,Jamalpur,Sarishabari,Doail,1,1,0,0,0,0,1,0,0
Mymensingh,Jamalpur,Sarishabari,Bhatara,3,3,0,0,0,0,2,0,1
Mymensingh,Jamalpur,Sarishabari,Aona,1,1,0,0,0,0,1,0,0
Mymensingh,Jamalpur,Sarishabari,Pogaldigha,1,1,0,0,0,0,1,0,0
Mymensingh,Jamalpur,Sarishabari,Sarishabari Paurashava,1,1,0,0,0,0,1,0,0
Mymensingh,Jamalpur,Sarishabari,Kamrabad,0,0,0,0,0,0,0,0,0
Mymensingh,Jamalpur,Sarishabari,Mahadan,0,0,0,0,0,0,0,0,0
Mymensingh,Jamalpur,Sarishabari,Pingna,0,0,0,0,0,0,0,0,0
Mymensingh,Jamalpur,Sarishabari,Satpoa,0,0,0,0,0,0,0,0,0
Mymensingh,Jamalpur,Sarishabari,###,7,7,0,0,0,0,6,0,1
Mymensingh,Jamalpur,Dewanganj,Par Ramrampur,1,1,0,0,0,1,0,0,0
Mymensingh,Jamalpur,Dewanganj,Chukaibari,2,2,0,0,0,1,1,0,0
Mymensingh,Jamalpur,Dewanganj,Chikajani,1,1,0,0,0,0,1,0,0
Mymensingh,Jamalpur,Dewanganj,Bahadurabad,1,1,0,0,0,0,1,0,0
Mymensingh,Jamalpur,Dewanganj,Dewanganj,1,1,0,0,0,0,1,0,0
Mymensingh,Jamalpur,Dewanganj,Char Aomkhaoa,0,0,0,0,0,0,0,0,0
Mymensingh,Jamalpur,Dewanganj,Dangdhara,0,0,0,0,0,0,0,0,0
Mymensingh,Jamalpur,Dewanganj,Dewanganj Paurashava,0,0,0,0,0,0,0,0,0
Mymensingh,Jamalpur,Dewanganj,Hatebhanga,0,0,0,0,0,0,0,0,0
Mymensingh,Jamalpur,Dewanganj,###,6,6,0,0,0,2,4,0,0
Mymensingh,Jamalpur,###,###,63,63,0,0,0,7,54,1,1
Mymensingh,Sherpur,Jhenaigati,Kangsha,2,2,0,0,0,0,2,0,0
Mymensingh,Sherpur,Jhenaigati,Hatibandha Malijhikanda,1,1,0,0,0,0,1,0,0
Mymensingh,Sherpur,Jhenaigati,Dhanshail,1,1,0,0,0,0,1,0,0
Mymensingh,Sherpur,Jhenaigati,Malijhikanda,1,1,0,0,0,0,1,0,0
Mymensingh,Sherpur,Jhenaigati,Nalkura,1,1,0,0,0,0,1,0,0
Mymensingh,Sherpur,Jhenaigati,Jhenaigati,2,2,0,0,0,1,1,0,0
Mymensingh,Sherpur,Jhenaigati,Gauripur,1,1,0,0,0,0,1,0,0
Mymensingh,Sherpur,Jhenaigati,###,9,9,0,0,0,1,8,0,0
Mymensingh,Sherpur,Sherpur Sadar,Lakshmanpur,1,1,0,0,0,0,1,0,0
Mymensingh,Sherpur,Sherpur Sadar,Pakuria,2,2,0,0,0,1,0,1,0
Mymensingh,Sherpur,Sherpur Sadar,Balair Char,1,1,0,0,0,1,0,0,0
Mymensingh,Sherpur,Sherpur Sadar,Bhatsala,1,1,0,0,0,0,1,0,0
Mymensingh,Sherpur,Sherpur Sadar,Sherpur Paurashava,4,2,2,0,2,0,2,0,0
Mymensingh,Sherpur,Sherpur Sadar,Betmari Ghughurakandi,1,1,0,0,0,1,0,0,0
Mymensingh,Sherpur,Sherpur Sadar,Char Pakshimari,1,1,0,0,0,0,1,0,0
Mymensingh,Sherpur,Sherpur Sadar,Char Sherpur,1,1,0,0,0,0,1,0,0
Mymensingh,Sherpur,Sherpur Sadar,Char Mucharia,1,1,0,0,0,1,0,0,0
Mymensingh,Sherpur,Sherpur Sadar,Bajitkhila,0,0,0,0,0,0,0,0,0
Mymensingh,Sherpur,Sherpur Sadar,Dhala,0,0,0,0,0,0,0,0,0
Mymensingh,Sherpur,Sherpur Sadar,Ghazir Khamar,0,0,0,0,0,0,0,0,0
Mymensingh,Sherpur,Sherpur Sadar,Kamarer Char,0,0,0,0,0,0,0,0,0
Mymensingh,Sherpur,Sherpur Sadar,Kamaria,0,0,0,0,0,0,0,0,0
Mymensingh,Sherpur,Sherpur Sadar,Rauha Betmari,0,0,0,0,0,0,0,0,0
Mymensingh,Sherpur,Sherpur Sadar,###,13,11,2,0,2,4,6,1,0
Mymensingh,Sherpur,Nakla,Gourdwar,1,1,0,0,0,0,1,0,0
Mymensingh,Sherpur,Nakla,Nakla,1,1,0,0,0,0,1,0,0
Mymensingh,Sherpur,Nakla,Talki,1,1,0,0,0,0,1,0,0
Mymensingh,Sherpur,Nakla,Urpha,1,1,0,0,0,0,1,0,0
Mymensingh,Sherpur,Nakla,Char Ashtadhar,1,1,0,0,0,0,1,0,0
Mymensingh,Sherpur,Nakla,Ganapaddi,1,1,0,0,0,0,1,0,0
Mymensingh,Sherpur,Nakla,Chandrakona,1,1,0,0,0,0,1,0,0
Mymensingh,Sherpur,Nakla,Pathakata,1,1,0,0,0,0,1,0,0
Mymensingh,Sherpur,Nakla,Baneshwardi,1,1,0,0,0,0,1,0,0
Mymensingh,Sherpur,Nakla,Nakla Paurashava,0,0,0,0,0,0,0,0,0
Mymensingh,Sherpur,Nakla,###,9,9,0,0,0,0,9,0,0
Mymensingh,Sherpur,Sreebardi,Kakilakura,2,2,0,0,0,1,1,0,0
Mymensingh,Sherpur,Sreebardi,Tantihati,1,1,0,0,0,1,0,0,0
Mymensingh,Sherpur,Sreebardi,Gosaipur,1,1,0,0,0,0,1,0,0
Mymensingh,Sherpur,Sreebardi,Rani Shimul,2,2,0,0,0,1,1,0,0
Mymensingh,Sherpur,Sreebardi,Kurikahania,1,1,0,0,0,0,1,0,0
Mymensingh,Sherpur,Sreebardi,Sreebardi Paurashava,1,1,0,0,0,0,1,0,0
Mymensingh,Sherpur,Sreebardi,Singa Baruna,1,1,0,0,0,1,0,0,0
Mymensingh,Sherpur,Sreebardi,Bhelua,1,1,0,0,0,0,1,0,0
Mymensingh,Sherpur,Sreebardi,Kharia Kazir Char,1,1,0,0,0,0,1,0,0
Mymensingh,Sherpur,Sreebardi,Garjaripa,0,0,0,0,0,0,0,0,0
Mymensingh,Sherpur,Sreebardi,Sreebardi,0,0,0,0,0,0,0,0,0
Mymensingh,Sherpur,Sreebardi,###,11,11,0,0,0,4,7,0,0
Mymensingh,Sherpur,Nalitabari,Baghber,2,2,0,0,0,1,1,0,0
Mymensingh,Sherpur,Nalitabari,Rajnagar,1,1,0,0,0,0,1,0,0
Mymensingh,Sherpur,Nalitabari,Kalaspur,1,1,0,0,0,0,1,0,0
Mymensingh,Sherpur,Nalitabari,Jogania,1,1,0,0,0,0,1,0,0
Mymensingh,Sherpur,Nalitabari,Nayabil,2,2,0,0,0,0,1,1,0
Mymensingh,Sherpur,Nalitabari,Marichpura,1,1,0,0,0,0,1,0,0
Mymensingh,Sherpur,Nalitabari,Nunni,1,1,0,0,0,0,1,0,0
Mymensingh,Sherpur,Nalitabari,Poragaon,1,1,0,0,0,1,0,0,0
Mymensingh,Sherpur,Nalitabari,Kakarkandi,0,0,0,0,0,0,0,0,0
Mymensingh,Sherpur,Nalitabari,Nalitabari,0,0,0,0,0,0,0,0,0
Mymensingh,Sherpur,Nalitabari,Nalitabari Paurashava,0,0,0,0,0,0,0,0,0
Mymensingh,Sherpur,Nalitabari,Ramchandrakura Mandalia,0,0,0,0,0,0,0,0,0
Mymensingh,Sherpur,Nalitabari,Rupnarayankura,0,0,0,0,0,0,0,0,0
Mymensingh,Sherpur,Nalitabari,###,10,10,0,0,0,2,7,1,0
Mymensingh,Sherpur,###,###,52,50,2,0,2,11,37,2,0
Mymensingh,###,###,###,310,279,31,19,12,24,107,74,74
Rangpur,Nilphamari,Nilphamari Sadar,Paurashava,2,1,1,1,0,0,1,0,0
Rangpur,Nilphamari,Nilphamari Sadar,Sonaroy,1,1,0,0,0,0,1,0,0
Rangpur,Nilphamari,Nilphamari Sadar,Chapra Saramjani,1,1,0,0,0,0,1,0,0
Rangpur,Nilphamari,Nilphamari Sadar,Sangalshi,1,1,0,0,0,0,1,0,0
Rangpur,Nilphamari,Nilphamari Sadar,Kunda Pukur,1,1,0,0,0,0,1,0,0
Rangpur,Nilphamari,Nilphamari Sadar,Lakshmi Chap,1,1,0,0,0,0,1,0,0
Rangpur,Nilphamari,Nilphamari Sadar,Palashbari,1,1,0,0,0,1,0,0,0
Rangpur,Nilphamari,Nilphamari Sadar,Gorgram,1,1,0,0,0,0,1,0,0
Rangpur,Nilphamari,Nilphamari Sadar,Ramnagar,1,1,0,0,0,0,1,0,0
Rangpur,Nilphamari,Nilphamari Sadar,Kachukata,1,1,0,0,0,0,1,0,0
Rangpur,Nilphamari,Nilphamari Sadar,Chaora Bargachha,0,0,0,0,0,0,0,0,0
Rangpur,Nilphamari,Nilphamari Sadar,Charaikhola,0,0,0,0,0,0,0,0,0
Rangpur,Nilphamari,Nilphamari Sadar,Itakhola,0,0,0,0,0,0,0,0,0
Rangpur,Nilphamari,Nilphamari Sadar,Khokshabari,0,0,0,0,0,0,0,0,0
Rangpur,Nilphamari,Nilphamari Sadar,Panch Pukur,0,0,0,0,0,0,0,0,0
Rangpur,Nilphamari,Nilphamari Sadar,Tupamari,0,0,0,0,0,0,0,0,0
Rangpur,Nilphamari,Nilphamari Sadar,###,11,10,1,1,0,1,9,0,0
Rangpur,Nilphamari,Saidpur,Paurashava,3,3,0,0,0,2,0,0,1
Rangpur,Nilphamari,Saidpur,Kushiram Belpukur,2,2,0,0,0,1,1,0,0
Rangpur,Nilphamari,Saidpur,Bangalipur,1,1,0,0,0,0,1,0,0
Rangpur,Nilphamari,Saidpur,Kamar Pukur,1,1,0,0,0,0,1,0,0
Rangpur,Nilphamari,Saidpur,Bothlagari,0,0,0,0,0,0,0,0,0
Rangpur,Nilphamari,Saidpur,Khata Madhupur,0,0,0,0,0,0,0,0,0
Rangpur,Nilphamari,Saidpur,###,7,7,0,0,0,3,3,0,1
Rangpur,Nilphamari,Dimla,Dimla,1,1,0,0,0,0,1,0,0
Rangpur,Nilphamari,Dimla,Tepa Kharibari,2,2,0,0,0,0,2,0,0
Rangpur,Nilphamari,Dimla,Khalisa Chapani,1,1,0,0,0,0,1,0,0
Rangpur,Nilphamari,Dimla,Bala Para,2,2,0,0,0,0,2,0,0
Rangpur,Nilphamari,Dimla,Jhunagachh Chapani,1,1,0,0,0,0,1,0,0
Rangpur,Nilphamari,Dimla,Paschim Chhatnai,1,1,0,0,0,1,0,0,0
Rangpur,Nilphamari,Dimla,Naotara,1,1,0,0,0,0,1,0,0
Rangpur,Nilphamari,Dimla,Gayabari,0,0,0,0,0,0,0,0,0
Rangpur,Nilphamari,Dimla,Khoga Kharibari,0,0,0,0,0,0,0,0,0
Rangpur,Nilphamari,Dimla,Purba Chhatnai,0,0,0,0,0,0,0,0,0
Rangpur,Nilphamari,Dimla,###,9,9,0,0,0,1,8,0,0
Rangpur,Nilphamari,Jaldhaka,Balagram,1,1,0,0,0,0,1,0,0
Rangpur,Nilphamari,Jaldhaka,Paurashava,2,2,0,0,0,1,0,1,0
Rangpur,Nilphamari,Jaldhaka,Daoabari,1,1,0,0,0,1,0,0,0
Rangpur,Nilphamari,Jaldhaka,Kaimari,1,1,0,0,0,1,0,0,0
Rangpur,Nilphamari,Jaldhaka,Golna,1,1,0,0,0,0,1,0,0
Rangpur,Nilphamari,Jaldhaka,Khutamara,1,1,0,0,0,0,1,0,0
Rangpur,Nilphamari,Jaldhaka,Mirganj,1,1,0,0,0,1,0,0,0
Rangpur,Nilphamari,Jaldhaka,Dharmapal,1,1,0,0,0,0,1,0,0
Rangpur,Nilphamari,Jaldhaka,Golmunda,0,0,0,0,0,0,0,0,0
Rangpur,Nilphamari,Jaldhaka,Kanthali,0,0,0,0,0,0,0,0,0
Rangpur,Nilphamari,Jaldhaka,Saulmari,0,0,0,0,0,0,0,0,0
Rangpur,Nilphamari,Jaldhaka,Shimulbari,0,0,0,0,0,0,0,0,0
Rangpur,Nilphamari,Jaldhaka,###,9,9,0,0,0,4,4,1,0
Rangpur,Nilphamari,Kishoreganj,Barabhita,1,1,0,0,0,0,1,0,0
Rangpur,Nilphamari,Kishoreganj,Ranachandi,1,1,0,0,0,0,1,0,0
Rangpur,Nilphamari,Kishoreganj,Magura,2,2,0,0,0,0,2,0,0
Rangpur,Nilphamari,Kishoreganj,Putimari,1,1,0,0,0,1,0,0,0
Rangpur,Nilphamari,Kishoreganj,Kishoreganj,1,1,0,0,0,1,0,0,0
Rangpur,Nilphamari,Kishoreganj,Garagram,1,1,0,0,0,1,0,0,0
Rangpur,Nilphamari,Kishoreganj,Bahagili,1,1,0,0,0,0,1,0,0
Rangpur,Nilphamari,Kishoreganj,Chandkhana,0,0,0,0,0,0,0,0,0
Rangpur,Nilphamari,Kishoreganj,Nitai,0,0,0,0,0,0,0,0,0
Rangpur,Nilphamari,Kishoreganj,###,8,8,0,0,0,3,5,0,0
Rangpur,Nilphamari,Domar,Domar,1,1,0,0,0,0,1,0,0
Rangpur,Nilphamari,Domar,Gomnati,1,1,0,0,0,0,1,0,0
Rangpur,Nilphamari,Domar,Sonaroy,1,1,0,0,0,0,1,0,0
Rangpur,Nilphamari,Domar,Jorabari,1,1,0,0,0,0,1,0,0
Rangpur,Nilphamari,Domar,Boragari,1,1,0,0,0,0,1,0,0
Rangpur,Nilphamari,Domar,Harinchara,1,1,0,0,0,0,1,0,0
Rangpur,Nilphamari,Domar,Panga Matukpur,1,1,0,0,0,0,1,0,0
Rangpur,Nilphamari,Domar,Bhogdabari,1,1,0,0,0,0,1,0,0
Rangpur,Nilphamari,Domar,Bamunia,0,0,0,0,0,0,0,0,0
Rangpur,Nilphamari,Domar,Ketkibari,0,0,0,0,0,0,0,0,0
Rangpur,Nilphamari,Domar,Paurashava,0,0,0,0,0,0,0,0,0
Rangpur,Nilphamari,Domar,###,8,8,0,0,0,0,8,0,0
Rangpur,Nilphamari,###,###,52,51,1,1,0,12,37,1,1
Rangpur,Rangpur,Rangpur Sadar,Paurashava,4,4,0,0,0,1,1,0,2
Rangpur,Rangpur,Rangpur Sadar,Tamphat,1,1,0,0,0,1,0,0,0
Rangpur,Rangpur,Rangpur Sadar,Darshana,1,1,0,0,0,0,1,0,0
Rangpur,Rangpur,Rangpur Sadar,Haridebpur,2,2,0,0,0,0,2,0,0
Rangpur,Rangpur,Rangpur Sadar,Mominpur,1,1,0,0,0,0,1,0,0
Rangpur,Rangpur,Rangpur Sadar,Chandanpat,1,1,0,0,0,0,1,0,0
Rangpur,Rangpur,Rangpur Sadar,Tapodhan,2,2,0,0,0,0,2,0,0
Rangpur,Rangpur,Rangpur Sadar,Sadya Pushkarni,1,1,0,0,0,0,1,0,0
Rangpur,Rangpur,Rangpur Sadar,Rajendrapur,1,1,0,0,0,0,1,0,0
Rangpur,Rangpur,Rangpur Sadar,Pashuram,0,0,0,0,0,0,0,0,0
Rangpur,Rangpur,Rangpur Sadar,Satgara,0,0,0,0,0,0,0,0,0
Rangpur,Rangpur,Rangpur Sadar,Uttam,0,0,0,0,0,0,0,0,0
Rangpur,Rangpur,Rangpur Sadar,###,14,14,0,0,0,2,10,0,2
Rangpur,Rangpur,Badarganj,Damodarpur,1,1,0,0,0,0,1,0,0
Rangpur,Rangpur,Badarganj,Gopinathpur,1,1,0,0,0,0,1,0,0
Rangpur,Rangpur,Badarganj,Madhupur,1,1,0,0,0,0,1,0,0
Rangpur,Rangpur,Badarganj,Bishnupur,1,1,0,0,0,0,1,0,0
Rangpur,Rangpur,Badarganj,Badarganj,2,2,0,0,0,0,2,0,0
Rangpur,Rangpur,Badarganj,Ramnathpur,1,1,0,0,0,0,1,0,0
Rangpur,Rangpur,Badarganj,Radhanagar,1,1,0,0,0,0,1,0,0
Rangpur,Rangpur,Badarganj,Gopalpur,1,1,0,0,0,1,0,0,0
Rangpur,Rangpur,Badarganj,Kutubpur,0,0,0,0,0,0,0,0,0
Rangpur,Rangpur,Badarganj,Lohani Para,0,0,0,0,0,0,0,0,0
Rangpur,Rangpur,Badarganj,Paurashava,0,0,0,0,0,0,0,0,0
Rangpur,Rangpur,Badarganj,###,9,9,0,0,0,1,8,0,0
Rangpur,Rangpur,Mitha Pukur,Chengmari,1,1,0,0,0,0,1,0,0
Rangpur,Rangpur,Mitha Pukur,Bara Hazratpur,1,1,0,0,0,0,1,0,0
Rangpur,Rangpur,Mitha Pukur,Mayenpur,1,1,0,0,0,0,1,0,0
Rangpur,Rangpur,Mitha Pukur,Khoragachh,1,1,0,0,0,0,1,0,0
Rangpur,Rangpur,Mitha Pukur,Gopalpur,1,1,0,0,0,0,1,0,0
Rangpur,Rangpur,Mitha Pukur,Durgapur,1,1,0,0,0,0,1,0,0
Rangpur,Rangpur,Mitha Pukur,Balua Masimpur,1,1,0,0,0,0,1,0,0
Rangpur,Rangpur,Mitha Pukur,Bhangni,1,1,0,0,0,0,1,0,0
Rangpur,Rangpur,Mitha Pukur,Latifpur,1,1,0,0,0,0,1,0,0
Rangpur,Rangpur,Mitha Pukur,Kafrikhal,1,1,0,0,0,0,1,0,0
Rangpur,Rangpur,Mitha Pukur,Emadpur,2,2,0,0,0,0,2,0,0
Rangpur,Rangpur,Mitha Pukur,Balarhat,2,2,0,0,0,0,1,1,0
Rangpur,Rangpur,Mitha Pukur,Pairaband,1,1,0,0,0,0,1,0,0
Rangpur,Rangpur,Mitha Pukur,Barabala,0,0,0,0,0,0,0,0,0
Rangpur,Rangpur,Mitha Pukur,Milanpur,0,0,0,0,0,0,0,0,0
Rangpur,Rangpur,Mitha Pukur,Mirzapur,0,0,0,0,0,0,0,0,0
Rangpur,Rangpur,Mitha Pukur,Rani Pukur,0,0,0,0,0,0,0,0,0
Rangpur,Rangpur,Mitha Pukur,###,15,15,0,0,0,0,14,1,0
Rangpur,Rangpur,Gangachara,Nohali,1,1,0,0,0,0,1,0,0
Rangpur,Rangpur,Gangachara,Gajaghanta,1,1,0,0,0,0,1,0,0
Rangpur,Rangpur,Gangachara,Alam Biditar,2,2,0,0,0,1,1,0,0
Rangpur,Rangpur,Gangachara,Gangachara,1,1,0,0,0,1,0,0,0
Rangpur,Rangpur,Gangachara,Khaleya,2,2,0,0,0,1,1,0,0
Rangpur,Rangpur,Gangachara,Kolkanda,1,1,0,0,0,0,1,0,0
Rangpur,Rangpur,Gangachara,Lakshmitari,1,1,0,0,0,0,1,0,0
Rangpur,Rangpur,Gangachara,Barabil,0,0,0,0,0,0,0,0,0
Rangpur,Rangpur,Gangachara,Betgari,0,0,0,0,0,0,0,0,0
Rangpur,Rangpur,Gangachara,Marania,0,0,0,0,0,0,0,0,0
Rangpur,Rangpur,Gangachara,###,9,9,0,0,0,3,6,0,0
Rangpur,Rangpur,Taraganj,Sayar,1,1,0,0,0,0,1,0,0
Rangpur,Rangpur,Taraganj,Kursha,2,2,0,0,0,0,2,0,0
Rangpur,Rangpur,Taraganj,Hariarkuti,1,1,0,0,0,0,1,0,0
Rangpur,Rangpur,Taraganj,Alampur,2,2,0,0,0,0,2,0,0
Rangpur,Rangpur,Taraganj,Ekarchali,0,0,0,0,0,0,0,0,0
Rangpur,Rangpur,Taraganj,###,6,6,0,0,0,0,6,0,0
Rangpur,Rangpur,Pirganj,Pirganj,1,1,0,0,0,0,1,0,0
Rangpur,Rangpur,Pirganj,Madankhali,1,1,0,0,0,0,1,0,0
Rangpur,Rangpur,Pirganj,Ramnathpur,2,2,0,0,0,0,2,0,0
Rangpur,Rangpur,Pirganj,Chatra,1,1,0,0,0,0,1,0,0
Rangpur,Rangpur,Pirganj,Shanerhat,1,1,0,0,0,0,1,0,0
Rangpur,Rangpur,Pirganj,Bhendabari,1,1,0,0,0,1,0,0,0
Rangpur,Rangpur,Pirganj,Chaitrakul,1,1,0,0,0,1,0,0,0
Rangpur,Rangpur,Pirganj,Kumedpur,1,1,0,0,0,0,1,0,0
Rangpur,Rangpur,Pirganj,Mithapur,1,1,0,0,0,1,0,0,0
Rangpur,Rangpur,Pirganj,Panchgachha,2,2,0,0,0,0,1,1,0
Rangpur,Rangpur,Pirganj,Bara Alampur,0,0,0,0,0,0,0,0,0
Rangpur,Rangpur,Pirganj,Bara Dargah,0,0,0,0,0,0,0,0,0
Rangpur,Rangpur,Pirganj,Kabilpur,0,0,0,0,0,0,0,0,0
Rangpur,Rangpur,Pirganj,Roypur,0,0,0,0,0,0,0,0,0
Rangpur,Rangpur,Pirganj,Tukuria,0,0,0,0,0,0,0,0,0
Rangpur,Rangpur,Pirganj,###,12,12,0,0,0,3,8,1,0
Rangpur,Rangpur,Pirgachha,Kalyani,1,1,0,0,0,0,1,0,0
Rangpur,Rangpur,Pirgachha,Parul,1,1,0,0,0,0,1,0,0
Rangpur,Rangpur,Pirgachha,Itakumari,1,1,0,0,0,0,1,0,0
Rangpur,Rangpur,Pirgachha,Pirgachha,2,2,0,0,0,0,1,1,0
Rangpur,Rangpur,Pirgachha,Chhaola,2,2,0,0,0,0,2,0,0
Rangpur,Rangpur,Pirgachha,Annadanagar,1,1,0,0,0,0,1,0,0
Rangpur,Rangpur,Pirgachha,Tambulpur,1,1,0,0,0,0,1,0,0
Rangpur,Rangpur,Pirgachha,Kandi,2,2,0,0,0,0,2,0,0
Rangpur,Rangpur,Pirgachha,Kaikuri,2,2,0,0,0,1,1,0,0
Rangpur,Rangpur,Pirgachha,###,13,13,0,0,0,1,11,1,0
Rangpur,Rangpur,Kaunia,Paurashava,1,1,0,0,0,0,1,0,0
Rangpur,Rangpur,Kaunia,Sarai,1,1,0,0,0,0,1,0,0
Rangpur,Rangpur,Kaunia,Kursha,2,2,0,0,0,1,1,0,0
Rangpur,Rangpur,Kaunia,Kaunia Bala Para,2,2,0,0,0,0,2,0,0
Rangpur,Rangpur,Kaunia,Shahidbagh,1,1,0,0,0,1,0,0,0
Rangpur,Rangpur,Kaunia,Tepa Madhupur,3,3,0,0,0,2,1,0,0
Rangpur,Rangpur,Kaunia,Haragachh,0,0,0,0,0,0,0,0,0
Rangpur,Rangpur,Kaunia,###,10,10,0,0,0,4,6,0,0
Rangpur,Rangpur,###,###,88,88,0,0,0,14,69,3,2
Rangpur,Lalmonirhat,Lalmonirhat Sadar,Paurashava,2,2,0,0,0,0,1,1,0
Rangpur,Lalmonirhat,Lalmonirhat Sadar,Harati,2,2,0,0,0,0,2,0,0
Rangpur,Lalmonirhat,Lalmonirhat Sadar,Gokunda,1,1,0,0,0,0,1,0,0
Rangpur,Lalmonirhat,Lalmonirhat Sadar,Mogalhat,1,1,0,0,0,0,1,0,0
Rangpur,Lalmonirhat,Lalmonirhat Sadar,Kulaghat,1,1,0,0,0,0,1,0,0
Rangpur,Lalmonirhat,Lalmonirhat Sadar,Barabari,1,1,0,0,0,0,1,0,0
Rangpur,Lalmonirhat,Lalmonirhat Sadar,Rajpur,1,1,0,0,0,0,1,0,0
Rangpur,Lalmonirhat,Lalmonirhat Sadar,Khuniagachh,0,0,0,0,0,0,0,0,0
Rangpur,Lalmonirhat,Lalmonirhat Sadar,Mahendranagar,0,0,0,0,0,0,0,0,0
Rangpur,Lalmonirhat,Lalmonirhat Sadar,Panchagram,0,0,0,0,0,0,0,0,0
Rangpur,Lalmonirhat,Lalmonirhat Sadar,###,9,9,0,0,0,0,8,1,0
Rangpur,Lalmonirhat,Kaliganj,Kakina,1,1,0,0,0,0,1,0,0
Rangpur,Lalmonirhat,Kaliganj,Chalbala,1,1,0,0,0,0,1,0,0
Rangpur,Lalmonirhat,Kaliganj,Goral,1,1,0,0,0,0,1,0,0
Rangpur,Lalmonirhat,Kaliganj,Chandrapur,1,1,0,0,0,1,0,0,0
Rangpur,Lalmonirhat,Kaliganj,Tushbhandar,1,1,0,0,0,0,1,0,0
Rangpur,Lalmonirhat,Kaliganj,Madati,1,1,0,0,0,0,1,0,0
Rangpur,Lalmonirhat,Kaliganj,Bhotemari,1,1,0,0,0,0,1,0,0
Rangpur,Lalmonirhat,Kaliganj,Dalagram,1,1,0,0,0,0,1,0,0
Rangpur,Lalmonirhat,Kaliganj,###,8,8,0,0,0,1,7,0,0
Rangpur,Lalmonirhat,Patgram,Burimari,1,1,0,0,0,0,1,0,0
Rangpur,Lalmonirhat,Patgram,Paurashava,1,1,0,0,0,1,0,0,0
Rangpur,Lalmonirhat,Patgram,Baura,1,1,0,0,0,1,0,0,0
Rangpur,Lalmonirhat,Patgram,Jongra,1,1,0,0,0,1,0,0,0
Rangpur,Lalmonirhat,Patgram,Patgram,1,1,0,0,0,1,0,0,0
Rangpur,Lalmonirhat,Patgram,Dahagram,1,1,0,0,0,0,1,0,0
Rangpur,Lalmonirhat,Patgram,Kuchlibari,1,1,0,0,0,0,1,0,0
Rangpur,Lalmonirhat,Patgram,Jagatber,0,0,0,0,0,0,0,0,0
Rangpur,Lalmonirhat,Patgram,Sreerampur,0,0,0,0,0,0,0,0,0
Rangpur,Lalmonirhat,Patgram,###,7,7,0,0,0,4,3,0,0
Rangpur,Lalmonirhat,Hatibandha,Sindurna,1,1,0,0,0,0,1,0,0
Rangpur,Lalmonirhat,Hatibandha,Barakhata,1,1,0,0,0,0,1,0,0
Rangpur,Lalmonirhat,Hatibandha,Tangbhanga,1,1,0,0,0,1,0,0,0
Rangpur,Lalmonirhat,Hatibandha,Shingimari,1,1,0,0,0,1,0,0,0
Rangpur,Lalmonirhat,Hatibandha,Gotamari,1,1,0,0,0,1,0,0,0
Rangpur,Lalmonirhat,Hatibandha,Daoabari,1,1,0,0,0,1,0,0,0
Rangpur,Lalmonirhat,Hatibandha,Goddimari,1,1,0,0,0,1,0,0,0
Rangpur,Lalmonirhat,Hatibandha,Bhalaguri,1,1,0,0,0,1,0,0,0
Rangpur,Lalmonirhat,Hatibandha,Fakir Para,0,0,0,0,0,0,0,0,0
Rangpur,Lalmonirhat,Hatibandha,Nowdabash,0,0,0,0,0,0,0,0,0
Rangpur,Lalmonirhat,Hatibandha,Patika Para,0,0,0,0,0,0,0,0,0
Rangpur,Lalmonirhat,Hatibandha,Saniajan,0,0,0,0,0,0,0,0,0
Rangpur,Lalmonirhat,Hatibandha,###,8,8,0,0,0,6,2,0,0
Rangpur,Lalmonirhat,Aditmari,Mahishkhocha,1,1,0,0,0,0,1,0,0
Rangpur,Lalmonirhat,Aditmari,Kamalabari,1,1,0,0,0,0,1,0,0
Rangpur,Lalmonirhat,Aditmari,Sarpukur,1,1,0,0,0,0,1,0,0
Rangpur,Lalmonirhat,Aditmari,Bhelabari,2,2,0,0,0,0,2,0,0
Rangpur,Lalmonirhat,Aditmari,Bhadai,1,1,0,0,0,0,1,0,0
Rangpur,Lalmonirhat,Aditmari,Palashi,1,1,0,0,0,0,1,0,0
Rangpur,Lalmonirhat,Aditmari,Durgapur,0,0,0,0,0,0,0,0,0
Rangpur,Lalmonirhat,Aditmari,Saptibari,0,0,0,0,0,0,0,0,0
Rangpur,Lalmonirhat,Aditmari,###,7,7,0,0,0,0,7,0,0
Rangpur,Lalmonirhat,###,###,39,39,0,0,0,11,27,1,0
Rangpur,Dinajpur,Biral,Azimpur,1,1,0,0,0,0,0,1,0
Rangpur,Dinajpur,Biral,Biral,1,1,0,0,0,0,1,0,0
Rangpur,Dinajpur,Biral,Farakkabad,1,1,0,0,0,0,1,0,0
Rangpur,Dinajpur,Biral,Dhamair,1,1,0,0,0,0,1,0,0
Rangpur,Dinajpur,Biral,Dharmapur,1,1,0,0,0,0,1,0,0
Rangpur,Dinajpur,Biral,Rani Pukur,1,1,0,0,0,0,1,0,0
Rangpur,Dinajpur,Biral,Mangalpur,1,1,0,0,0,0,1,0,0
Rangpur,Dinajpur,Biral,Sahargram,1,1,0,0,0,0,1,0,0
Rangpur,Dinajpur,Biral,Bhandara,0,0,0,0,0,0,0,0,0
Rangpur,Dinajpur,Biral,Bijora,0,0,0,0,0,0,0,0,0
Rangpur,Dinajpur,Biral,###,8,8,0,0,0,0,7,1,0
Rangpur,Dinajpur,Dinajpur Sadar,Paurashava,1,1,0,0,0,0,1,0,0
Rangpur,Dinajpur,Dinajpur Sadar,Shankarpur,1,1,0,0,0,0,1,0,0
Rangpur,Dinajpur,Dinajpur Sadar,Chehelgazi,2,2,0,0,0,0,2,0,0
Rangpur,Dinajpur,Dinajpur Sadar,Auliapur,1,1,0,0,0,1,0,0,0
Rangpur,Dinajpur,Dinajpur Sadar,Uthrail,1,1,0,0,0,0,1,0,0
Rangpur,Dinajpur,Dinajpur Sadar,Askarpur,1,1,0,0,0,0,1,0,0
Rangpur,Dinajpur,Dinajpur Sadar,Sundarban,1,1,0,0,0,0,1,0,0
Rangpur,Dinajpur,Dinajpur Sadar,Sekhpura,1,1,0,0,0,0,1,0,0
Rangpur,Dinajpur,Dinajpur Sadar,Fazilpur,0,0,0,0,0,0,0,0,0
Rangpur,Dinajpur,Dinajpur Sadar,Kamalpur,0,0,0,0,0,0,0,0,0
Rangpur,Dinajpur,Dinajpur Sadar,Shashara,0,0,0,0,0,0,0,0,0
Rangpur,Dinajpur,Dinajpur Sadar,###,9,9,0,0,0,1,8,0,0
Rangpur,Dinajpur,Fulbari,Daulatpur,2,2,0,0,0,0,2,0,0
Rangpur,Dinajpur,Fulbari,Aladipur,1,1,0,0,0,0,1,0,0
Rangpur,Dinajpur,Fulbari,Khayerbari,1,1,0,0,0,0,1,0,0
Rangpur,Dinajpur,Fulbari,Shibnagar,3,3,0,0,0,0,3,0,0
Rangpur,Dinajpur,Fulbari,Eluary,1,1,0,0,0,0,1,0,0
Rangpur,Dinajpur,Fulbari,Betdighi,1,1,0,0,0,0,1,0,0
Rangpur,Dinajpur,Fulbari,Kazihal,0,0,0,0,0,0,0,0,0
Rangpur,Dinajpur,Fulbari,Paurashava,0,0,0,0,0,0,0,0,0
Rangpur,Dinajpur,Fulbari,###,9,9,0,0,0,0,9,0,0
Rangpur,Dinajpur,Chirirbandar,Aulia Pukur,1,1,0,0,0,0,1,0,0
Rangpur,Dinajpur,Chirirbandar,Bhiail,1,1,0,0,0,0,1,0,0
Rangpur,Dinajpur,Chirirbandar,Abdulpur,2,2,0,0,0,0,2,0,0
Rangpur,Dinajpur,Chirirbandar,Amarpur,1,1,0,0,0,0,1,0,0
Rangpur,Dinajpur,Chirirbandar,Isabpur,1,1,0,0,0,0,1,0,0
Rangpur,Dinajpur,Chirirbandar,Alokdihi,1,1,0,0,0,0,1,0,0
Rangpur,Dinajpur,Chirirbandar,Nasratpur,1,1,0,0,0,0,1,0,0
Rangpur,Dinajpur,Chirirbandar,Fatehjanapur,0,0,0,0,0,0,0,0,0
Rangpur,Dinajpur,Chirirbandar,Punatti,0,0,0,0,0,0,0,0,0
Rangpur,Dinajpur,Chirirbandar,Saintara,0,0,0,0,0,0,0,0,0
Rangpur,Dinajpur,Chirirbandar,Satnala,0,0,0,0,0,0,0,0,0
Rangpur,Dinajpur,Chirirbandar,Tentulia,0,0,0,0,0,0,0,0,0
Rangpur,Dinajpur,Chirirbandar,###,8,8,0,0,0,0,8,0,0
Rangpur,Dinajpur,Nawabganj,Putimara,1,1,0,0,0,0,1,0,0
Rangpur,Dinajpur,Nawabganj,Mahmudpur,1,1,0,0,0,0,1,0,0
Rangpur,Dinajpur,Nawabganj,Kushdaha,1,1,0,0,0,0,1,0,0
Rangpur,Dinajpur,Nawabganj,Golapganj,1,1,0,0,0,0,1,0,0
Rangpur,Dinajpur,Nawabganj,Bhaduria,1,1,0,0,0,0,1,0,0
Rangpur,Dinajpur,Nawabganj,Joypur,1,1,0,0,0,0,1,0,0
Rangpur,Dinajpur,Nawabganj,Daudpur,1,1,0,0,0,0,1,0,0
Rangpur,Dinajpur,Nawabganj,Binodnagar,1,1,0,0,0,0,1,0,0
Rangpur,Dinajpur,Nawabganj,Shalkhuria,0,0,0,0,0,0,0,0,0
Rangpur,Dinajpur,Nawabganj,###,8,8,0,0,0,0,8,0,0
Rangpur,Dinajpur,Ghoraghat,Palsa,1,1,0,0,0,0,1,0,0
Rangpur,Dinajpur,Ghoraghat,Bulakipur,1,1,0,0,0,0,1,0,0
Rangpur,Dinajpur,Ghoraghat,Singra,2,2,0,0,0,0,2,0,0
Rangpur,Dinajpur,Ghoraghat,Ghoraghat,1,1,0,0,0,0,1,0,0
Rangpur,Dinajpur,Ghoraghat,Paurashava,1,1,0,0,0,0,1,0,0
Rangpur,Dinajpur,Ghoraghat,###,6,6,0,0,0,0,6,0,0
Rangpur,Dinajpur,Birganj,Bhognagar,1,1,0,0,0,0,1,0,0
Rangpur,Dinajpur,Birganj,Nijpara,1,1,0,0,0,0,1,0,0
Rangpur,Dinajpur,Birganj,Satair,1,1,0,0,0,0,1,0,0
Rangpur,Dinajpur,Birganj,Shatagram,1,1,0,0,0,0,1,0,0
Rangpur,Dinajpur,Birganj,Paurashava,1,1,0,0,0,1,0,0,0
Rangpur,Dinajpur,Birganj,Mohanpur,2,2,0,0,0,1,1,0,0
Rangpur,Dinajpur,Birganj,Maricha,1,1,0,0,0,0,1,0,0
Rangpur,Dinajpur,Birganj,Mohammadpur,1,1,0,0,0,0,1,0,0
Rangpur,Dinajpur,Birganj,Palashbari,1,1,0,0,0,0,1,0,0
Rangpur,Dinajpur,Birganj,Paltapur,0,0,0,0,0,0,0,0,0
Rangpur,Dinajpur,Birganj,Shibrampur,0,0,0,0,0,0,0,0,0
Rangpur,Dinajpur,Birganj,Sujalpur,0,0,0,0,0,0,0,0,0
Rangpur,Dinajpur,Birganj,###,10,10,0,0,0,2,8,0,0
Rangpur,Dinajpur,Birampur,Paurashava,2,2,0,0,0,1,1,0,0
Rangpur,Dinajpur,Birampur,Deor,1,1,0,0,0,0,1,0,0
Rangpur,Dinajpur,Birampur,Pali Prayagpur,1,1,0,0,0,0,1,0,0
Rangpur,Dinajpur,Birampur,Katla,1,1,0,0,0,0,1,0,0
Rangpur,Dinajpur,Birampur,Benail,0,0,0,0,0,0,0,0,0
Rangpur,Dinajpur,Birampur,Jotbani,0,0,0,0,0,0,0,0,0
Rangpur,Dinajpur,Birampur,Khanpur,0,0,0,0,0,0,0,0,0
Rangpur,Dinajpur,Birampur,Mukundapur,0,0,0,0,0,0,0,0,0
Rangpur,Dinajpur,Birampur,###,5,5,0,0,0,1,4,0,0
Rangpur,Dinajpur,Hakimpur,Khatta Madhab Para,1,1,0,0,0,0,1,0,0
Rangpur,Dinajpur,Hakimpur,Boaldar,1,1,0,0,0,0,1,0,0
Rangpur,Dinajpur,Hakimpur,Paurashava,2,2,0,0,0,0,2,0,0
Rangpur,Dinajpur,Hakimpur,Alihat,1,1,0,0,0,0,1,0,0
Rangpur,Dinajpur,Hakimpur,###,5,5,0,0,0,0,5,0,0
Rangpur,Dinajpur,Parbatipur,Mominpur,1,1,0,0,0,0,1,0,0
Rangpur,Dinajpur,Parbatipur,Manmathapur,1,1,0,0,0,0,1,0,0
Rangpur,Dinajpur,Parbatipur,Belaichandi,1,1,0,0,0,0,1,0,0
Rangpur,Dinajpur,Parbatipur,Habra,1,1,0,0,0,0,1,0,0
Rangpur,Dinajpur,Parbatipur,Hamidpur,1,1,0,0,0,0,1,0,0
Rangpur,Dinajpur,Parbatipur,Palashbari,1,1,0,0,0,0,1,0,0
Rangpur,Dinajpur,Parbatipur,Rampur,1,1,0,0,0,0,1,0,0
Rangpur,Dinajpur,Parbatipur,Chandipur,0,0,0,0,0,0,0,0,0
Rangpur,Dinajpur,Parbatipur,Harirampur,0,0,0,0,0,0,0,0,0
Rangpur,Dinajpur,Parbatipur,Mostafapur,0,0,0,0,0,0,0,0,0
Rangpur,Dinajpur,Parbatipur,Paurashava,0,0,0,0,0,0,0,0,0
Rangpur,Dinajpur,Parbatipur,###,7,7,0,0,0,0,7,0,0
Rangpur,Dinajpur,Bochaganj,Atgaon,1,1,0,0,0,0,1,0,0
Rangpur,Dinajpur,Bochaganj,Ishania,2,2,0,0,0,0,2,0,0
Rangpur,Dinajpur,Bochaganj,Chhatail,1,1,0,0,0,0,1,0,0
Rangpur,Dinajpur,Bochaganj,Setabganj Paurashava,1,1,0,0,0,1,0,0,0
Rangpur,Dinajpur,Bochaganj,Rangaon,1,1,0,0,0,0,1,0,0
Rangpur,Dinajpur,Bochaganj,Mushidhat,0,0,0,0,0,0,0,0,0
Rangpur,Dinajpur,Bochaganj,Nafanagar,0,0,0,0,0,0,0,0,0
Rangpur,Dinajpur,Bochaganj,###,6,6,0,0,0,1,5,0,0
Rangpur,Dinajpur,Kaharole,Targaon,1,1,0,0,0,0,1,0,0
Rangpur,Dinajpur,Kaharole,Rasulpur,2,2,0,0,0,0,2,0,0
Rangpur,Dinajpur,Kaharole,Ramchandrapur,1,1,0,0,0,0,1,0,0
Rangpur,Dinajpur,Kaharole,Dabar,1,1,0,0,0,0,1,0,0
Rangpur,Dinajpur,Kaharole,Sundarpur,1,1,0,0,0,0,1,0,0
Rangpur,Dinajpur,Kaharole,Mukundapur,0,0,0,0,0,0,0,0,0
Rangpur,Dinajpur,Kaharole,###,6,6,0,0,0,0,6,0,0
Rangpur,Dinajpur,Khansama,Bhabki,1,1,0,0,0,0,1,0,0
Rangpur,Dinajpur,Khansama,Khamar Para,2,2,0,0,0,0,2,0,0
Rangpur,Dinajpur,Khansama,Goaldihi,1,1,0,0,0,0,1,0,0
Rangpur,Dinajpur,Khansama,Alokjhari,1,1,0,0,0,0,1,0,0
Rangpur,Dinajpur,Khansama,Angar Para,0,0,0,0,0,0,0,0,0
Rangpur,Dinajpur,Khansama,Bherbheri,0,0,0,0,0,0,0,0,0
Rangpur,Dinajpur,Khansama,###,5,5,0,0,0,0,5,0,0
Rangpur,Dinajpur,###,###,92,92,0,0,0,5,86,1,0
Rangpur,Gaibandha,Palashbari,Pabnapur,1,1,0,0,0,0,1,0,0
Rangpur,Gaibandha,Palashbari,Kishoregari,1,1,0,0,0,0,1,0,0
Rangpur,Gaibandha,Palashbari,Manoharpur,1,1,0,0,0,1,0,0,0
Rangpur,Gaibandha,Palashbari,Palashbari,2,1,1,1,0,0,1,0,0
Rangpur,Gaibandha,Palashbari,Hossainpur,1,1,0,0,0,0,1,0,0
Rangpur,Gaibandha,Palashbari,Barisal,1,1,0,0,0,0,1,0,0
Rangpur,Gaibandha,Palashbari,Harinathpur,1,1,0,0,0,1,0,0,0
Rangpur,Gaibandha,Palashbari,Mohadipur,1,1,0,0,0,1,0,0,0
Rangpur,Gaibandha,Palashbari,Betkapa,0,0,0,0,0,0,0,0,0
Rangpur,Gaibandha,Palashbari,###,9,8,1,1,0,3,5,0,0
Rangpur,Gaibandha,Gobindaganj,Katabari,1,1,0,0,0,0,1,0,0
Rangpur,Gaibandha,Gobindaganj,Kamdia,1,1,0,0,0,0,1,0,0
Rangpur,Gaibandha,Gobindaganj,Mahimaganj,2,2,0,0,0,0,2,0,0
Rangpur,Gaibandha,Gobindaganj,Kochasahar,2,2,0,0,0,1,1,0,0
Rangpur,Gaibandha,Gobindaganj,Shakhahar,1,1,0,0,0,1,0,0,0
Rangpur,Gaibandha,Gobindaganj,Rajahar,1,1,0,0,0,0,1,0,0
Rangpur,Gaibandha,Gobindaganj,Taluk Kanupur,1,1,0,0,0,1,0,0,0
Rangpur,Gaibandha,Gobindaganj,Sapmara,1,1,0,0,0,0,1,0,0
Rangpur,Gaibandha,Gobindaganj,Gumaniganj,1,1,0,0,0,0,1,0,0
Rangpur,Gaibandha,Gobindaganj,Rakhal Buruz,1,1,0,0,0,0,1,0,0
Rangpur,Gaibandha,Gobindaganj,Kamardaha,1,1,0,0,0,0,1,0,0
Rangpur,Gaibandha,Gobindaganj,Fulbari,1,1,0,0,0,0,1,0,0
Rangpur,Gaibandha,Gobindaganj,Darbasta,0,0,0,0,0,0,0,0,0
Rangpur,Gaibandha,Gobindaganj,Harirampur,0,0,0,0,0,0,0,0,0
Rangpur,Gaibandha,Gobindaganj,Nakai,0,0,0,0,0,0,0,0,0
Rangpur,Gaibandha,Gobindaganj,Paurashava,0,0,0,0,0,0,0,0,0
Rangpur,Gaibandha,Gobindaganj,Shalmara,0,0,0,0,0,0,0,0,0
Rangpur,Gaibandha,Gobindaganj,Shibpur,0,0,0,0,0,0,0,0,0
Rangpur,Gaibandha,Gobindaganj,###,14,14,0,0,0,3,11,0,0
Rangpur,Gaibandha,Saghatta,Bonar Para,1,1,0,0,0,0,1,0,0
Rangpur,Gaibandha,Saghatta,Kamaler Para,2,2,0,0,0,0,2,0,0
Rangpur,Gaibandha,Saghatta,Sughatta,1,1,0,0,0,1,0,0,0
Rangpur,Gaibandha,Saghatta,Kachua,1,1,0,0,0,0,1,0,0
Rangpur,Gaibandha,Saghatta,Ghuridaha,1,1,0,0,0,0,1,0,0
Rangpur,Gaibandha,Saghatta,Bhartkhali,1,1,0,0,0,0,1,0,0
Rangpur,Gaibandha,Saghatta,Haldia,0,0,0,0,0,0,0,0,0
Rangpur,Gaibandha,Saghatta,Jummerbari,0,0,0,0,0,0,0,0,0
Rangpur,Gaibandha,Saghatta,Muktanagar,0,0,0,0,0,0,0,0,0
Rangpur,Gaibandha,Saghatta,Padumsahar,0,0,0,0,0,0,0,0,0
Rangpur,Gaibandha,Saghatta,###,7,7,0,0,0,1,6,0,0
Rangpur,Gaibandha,Gaibandha Sadar,Paurashava,3,2,1,1,0,1,1,0,0
Rangpur,Gaibandha,Gaibandha Sadar,Malibari,1,1,0,0,0,0,1,0,0
Rangpur,Gaibandha,Gaibandha Sadar,Kuptala,1,1,0,0,0,0,1,0,0
Rangpur,Gaibandha,Gaibandha Sadar,Boali,1,1,0,0,0,0,1,0,0
Rangpur,Gaibandha,Gaibandha Sadar,Kholahati,2,1,1,1,0,0,1,0,0
Rangpur,Gaibandha,Gaibandha Sadar,Lakshmipur,1,1,0,0,0,0,1,0,0
Rangpur,Gaibandha,Gaibandha Sadar,Saha Para,2,2,0,0,0,0,2,0,0
Rangpur,Gaibandha,Gaibandha Sadar,Ramchandrapur,1,1,0,0,0,0,1,0,0
Rangpur,Gaibandha,Gaibandha Sadar,Badiakhali,1,1,0,0,0,0,1,0,0
Rangpur,Gaibandha,Gaibandha Sadar,Ballamjhar,0,0,0,0,0,0,0,0,0
Rangpur,Gaibandha,Gaibandha Sadar,Ghagoa,0,0,0,0,0,0,0,0,0
Rangpur,Gaibandha,Gaibandha Sadar,Gidari,0,0,0,0,0,0,0,0,0
Rangpur,Gaibandha,Gaibandha Sadar,Kamarjani,0,0,0,0,0,0,0,0,0
Rangpur,Gaibandha,Gaibandha Sadar,Mollar Char,0,0,0,0,0,0,0,0,0
Rangpur,Gaibandha,Gaibandha Sadar,###,13,11,2,2,0,1,10,0,0
Rangpur,Gaibandha,Sundarganj,Ramjiban,1,1,0,0,0,0,1,0,0
Rangpur,Gaibandha,Sundarganj,Sundarganj Paurashava,2,2,0,0,0,1,1,0,0
Rangpur,Gaibandha,Sundarganj,Kapasia,1,1,0,0,0,1,0,0,0
Rangpur,Gaibandha,Sundarganj,Sreepur,1,1,0,0,0,0,1,0,0
Rangpur,Gaibandha,Sundarganj,Belka,1,1,0,0,0,0,1,0,0
Rangpur,Gaibandha,Sundarganj,Chhaparhati,1,1,0,0,0,0,1,0,0
Rangpur,Gaibandha,Sundarganj,Kanchibari,1,1,0,0,0,0,1,0,0
Rangpur,Gaibandha,Sundarganj,Tarapur,1,1,0,0,0,0,1,0,0
Rangpur,Gaibandha,Sundarganj,Sarbananda,1,1,0,0,0,0,1,0,0
Rangpur,Gaibandha,Sundarganj,Bamandanga,0,0,0,0,0,0,0,0,0
Rangpur,Gaibandha,Sundarganj,Chandipur,0,0,0,0,0,0,0,0,0
Rangpur,Gaibandha,Sundarganj,Dahabanda,0,0,0,0,0,0,0,0,0
Rangpur,Gaibandha,Sundarganj,Dhopadanga,0,0,0,0,0,0,0,0,0
Rangpur,Gaibandha,Sundarganj,Haripur,0,0,0,0,0,0,0,0,0
Rangpur,Gaibandha,Sundarganj,Shantiram,0,0,0,0,0,0,0,0,0
Rangpur,Gaibandha,Sundarganj,Sonaroy,0,0,0,0,0,0,0,0,0
Rangpur,Gaibandha,Sundarganj,###,10,10,0,0,0,2,8,0,0
Rangpur,Gaibandha,Fulchhari,Udakhali,2,2,0,0,0,0,2,0,0
Rangpur,Gaibandha,Fulchhari,Gazaria,2,2,0,0,0,1,1,0,0
Rangpur,Gaibandha,Fulchhari,Fulchhari,2,2,0,0,0,1,1,0,0
Rangpur,Gaibandha,Fulchhari,Fazlupur,1,1,0,0,0,0,1,0,0
Rangpur,Gaibandha,Fulchhari,Kanchi Para,2,2,0,0,0,0,2,0,0
Rangpur,Gaibandha,Fulchhari,Erendabari,0,0,0,0,0,0,0,0,0
Rangpur,Gaibandha,Fulchhari,Uria,0,0,0,0,0,0,0,0,0
Rangpur,Gaibandha,Fulchhari,###,9,9,0,0,0,2,7,0,0
Rangpur,Gaibandha,Sadullapur,Dhaperhat,1,1,0,0,0,0,1,0,0
Rangpur,Gaibandha,Sadullapur,Kumar Para,1,1,0,0,0,1,0,0,0
Rangpur,Gaibandha,Sadullapur,Bhatgram,2,2,0,0,0,2,0,0,0
Rangpur,Gaibandha,Sadullapur,Rasulpur,1,1,0,0,0,0,1,0,0
Rangpur,Gaibandha,Sadullapur,Naldanga,1,1,0,0,0,0,1,0,0
Rangpur,Gaibandha,Sadullapur,Faridpur,1,1,0,0,0,1,0,0,0
Rangpur,Gaibandha,Sadullapur,Banagram,1,1,0,0,0,0,1,0,0
Rangpur,Gaibandha,Sadullapur,Damodarpur,1,1,0,0,0,1,0,0,0
Rangpur,Gaibandha,Sadullapur,Idilpur,0,0,0,0,0,0,0,0,0
Rangpur,Gaibandha,Sadullapur,Jamalpur,0,0,0,0,0,0,0,0,0
Rangpur,Gaibandha,Sadullapur,Khurda Kamarpur,0,0,0,0,0,0,0,0,0
Rangpur,Gaibandha,Sadullapur,###,9,9,0,0,0,5,4,0,0
Rangpur,Gaibandha,###,###,71,68,3,3,0,17,51,0,0
Rangpur,Kurigram,Nageshwari,Paurashava,2,2,0,0,0,1,1,0,0
Rangpur,Kurigram,Nageshwari,Bhitarband,1,1,0,0,0,0,1,0,0
Rangpur,Kurigram,Nageshwari,Royganj,1,1,0,0,0,0,1,0,0
Rangpur,Kurigram,Nageshwari,Ramkhana,1,1,0,0,0,0,1,0,0
Rangpur,Kurigram,Nageshwari,Narayanpur,1,1,0,0,0,1,0,0,0
Rangpur,Kurigram,Nageshwari,Bamandanga,1,1,0,0,0,0,1,0,0
Rangpur,Kurigram,Nageshwari,Santoshpur,1,1,0,0,0,0,1,0,0
Rangpur,Kurigram,Nageshwari,Kaliganj,1,1,0,0,0,0,1,0,0
Rangpur,Kurigram,Nageshwari,Kedar,1,1,0,0,0,0,1,0,0
Rangpur,Kurigram,Nageshwari,Kachakata,1,1,0,0,0,0,1,0,0
Rangpur,Kurigram,Nageshwari,Ballabher Khas,0,0,0,0,0,0,0,0,0
Rangpur,Kurigram,Nageshwari,Berubari,0,0,0,0,0,0,0,0,0
Rangpur,Kurigram,Nageshwari,Hasnabad,0,0,0,0,0,0,0,0,0
Rangpur,Kurigram,Nageshwari,Newashi,0,0,0,0,0,0,0,0,0
Rangpur,Kurigram,Nageshwari,Noonkhawa,0,0,0,0,0,0,0,0,0
Rangpur,Kurigram,Nageshwari,###,11,11,0,0,0,2,9,0,0
Rangpur,Kurigram,Chilmari,Raniganj,1,1,0,0,0,0,1,0,0
Rangpur,Kurigram,Chilmari,Ashtamir Char,2,2,0,0,0,2,0,0,0
Rangpur,Kurigram,Chilmari,Nayerhat,1,1,0,0,0,0,1,0,0
Rangpur,Kurigram,Chilmari,Thanahat,2,2,0,0,0,0,1,1,0
Rangpur,Kurigram,Chilmari,Ramna,2,2,0,0,0,1,1,0,0
Rangpur,Kurigram,Chilmari,Chilmari,0,0,0,0,0,0,0,0,0
Rangpur,Kurigram,Chilmari,###,8,8,0,0,0,3,4,1,0
Rangpur,Kurigram,Phulbari,Phulbari,1,1,0,0,0,1,0,0,0
Rangpur,Kurigram,Phulbari,Bhangamon,1,1,0,0,0,1,0,0,0
Rangpur,Kurigram,Phulbari,Shimulbari,1,1,0,0,0,1,0,0,0
Rangpur,Kurigram,Phulbari,Bara Bhita,1,1,0,0,0,1,0,0,0
Rangpur,Kurigram,Phulbari,Naodanga,1,1,0,0,0,1,0,0,0
Rangpur,Kurigram,Phulbari,Kashipur,1,1,0,0,0,1,0,0,0
Rangpur,Kurigram,Phulbari,###,6,6,0,0,0,6,0,0,0
Rangpur,Kurigram,Kurigram Sadar,Kanthalbari,2,2,0,0,0,1,1,0,0
Rangpur,Kurigram,Kurigram Sadar,Jatrapur,1,1,0,0,0,1,0,0,0
Rangpur,Kurigram,Kurigram Sadar,Mogalbachha,2,1,1,1,0,1,0,0,0
Rangpur,Kurigram,Kurigram Sadar,Punchgachhi,1,1,0,0,0,1,0,0,0
Rangpur,Kurigram,Kurigram Sadar,Bhogdanga,1,1,0,0,0,1,0,0,0
Rangpur,Kurigram,Kurigram Sadar,Ghogadaha,1,1,0,0,0,1,0,0,0
Rangpur,Kurigram,Kurigram Sadar,Paurashava,1,1,0,0,0,1,0,0,0
Rangpur,Kurigram,Kurigram Sadar,Belgachha,1,1,0,0,0,0,1,0,0
Rangpur,Kurigram,Kurigram Sadar,Holokhana,0,0,0,0,0,0,0,0,0
Rangpur,Kurigram,Kurigram Sadar,###,10,9,1,1,0,7,2,0,0
Rangpur,Kurigram,Ulipur,Bazra,1,1,0,0,0,1,0,0,0
Rangpur,Kurigram,Ulipur,Paurashava,1,1,0,0,0,1,0,0,0
Rangpur,Kurigram,Ulipur,Dhamserni,1,1,0,0,0,1,0,0,0
Rangpur,Kurigram,Ulipur,Daldalia,1,1,0,0,0,1,0,0,0
Rangpur,Kurigram,Ulipur,Durgapur,2,2,0,0,0,1,1,0,0
Rangpur,Kurigram,Ulipur,Tabakpur,1,1,0,0,0,0,0,1,0
Rangpur,Kurigram,Ulipur,Thetroy,1,1,0,0,0,0,1,0,0
Rangpur,Kurigram,Ulipur,Begumganj,1,1,0,0,0,1,0,0,0
Rangpur,Kurigram,Ulipur,Buraburi,0,0,0,0,0,0,0,0,0
Rangpur,Kurigram,Ulipur,Dharanibari,0,0,0,0,0,0,0,0,0
Rangpur,Kurigram,Ulipur,Gunaigachh,0,0,0,0,0,0,0,0,0
Rangpur,Kurigram,Ulipur,Hatia,0,0,0,0,0,0,0,0,0
Rangpur,Kurigram,Ulipur,Pandul,0,0,0,0,0,0,0,0,0
Rangpur,Kurigram,Ulipur,Saheber Alga,0,0,0,0,0,0,0,0,0
Rangpur,Kurigram,Ulipur,###,9,9,0,0,0,6,2,1,0
Rangpur,Kurigram,Bhurungamari,Joymanirhat,1,1,0,0,0,1,0,0,0
Rangpur,Kurigram,Bhurungamari,Shilkhuri,1,1,0,0,0,1,0,0,0
Rangpur,Kurigram,Bhurungamari,Bhurungamari,2,2,0,0,0,1,0,1,0
Rangpur,Kurigram,Bhurungamari,Paiker Chhara,1,1,0,0,0,1,0,0,0
Rangpur,Kurigram,Bhurungamari,Char Bhurungamari,1,1,0,0,0,1,0,0,0
Rangpur,Kurigram,Bhurungamari,Pathardubi,1,1,0,0,0,0,1,0,0
Rangpur,Kurigram,Bhurungamari,Boldia,1,1,0,0,0,0,1,0,0
Rangpur,Kurigram,Bhurungamari,Andhari Jhar,0,0,0,0,0,0,0,0,0
Rangpur,Kurigram,Bhurungamari,Bangasonahat,0,0,0,0,0,0,0,0,0
Rangpur,Kurigram,Bhurungamari,Tilai,0,0,0,0,0,0,0,0,0
Rangpur,Kurigram,Bhurungamari,###,8,8,0,0,0,5,2,1,0
Rangpur,Kurigram,Char Rajibpur,Kodailkati,3,3,0,0,0,1,2,0,0
Rangpur,Kurigram,Char Rajibpur,Char Rajibpur,2,2,0,0,0,0,2,0,0
Rangpur,Kurigram,Char Rajibpur,Mohanganj,1,1,0,0,0,0,1,0,0
Rangpur,Kurigram,Char Rajibpur,###,6,6,0,0,0,1,5,0,0
Rangpur,Kurigram,Rajarhat,Gharialdanga,1,1,0,0,0,1,0,0,0
Rangpur,Kurigram,Rajarhat,Chhinai,2,2,0,0,0,0,2,0,0
Rangpur,Kurigram,Rajarhat,Rajarhat,1,1,0,0,0,0,1,0,0
Rangpur,Kurigram,Rajarhat,Chakirpashar,2,2,0,0,0,1,1,0,0
Rangpur,Kurigram,Rajarhat,Nazimkhan,1,1,0,0,0,1,0,0,0
Rangpur,Kurigram,Rajarhat,Bidyananda,1,1,0,0,0,1,0,0,0
Rangpur,Kurigram,Rajarhat,Omar Majid,1,1,0,0,0,1,0,0,0
Rangpur,Kurigram,Rajarhat,###,9,9,0,0,0,5,4,0,0
Rangpur,Kurigram,Raumari,Bandaber,2,2,0,0,0,0,2,0,0
Rangpur,Kurigram,Raumari,Jadur Char,2,2,0,0,0,0,2,0,0
Rangpur,Kurigram,Raumari,Raumari,3,3,0,0,0,0,3,0,0
Rangpur,Kurigram,Raumari,Saulmari,1,1,0,0,0,0,1,0,0
Rangpur,Kurigram,Raumari,Dantbhanga,1,1,0,0,0,0,1,0,0
Rangpur,Kurigram,Raumari,###,9,9,0,0,0,0,9,0,0
Rangpur,Kurigram,###,###,76,75,1,1,0,35,37,3,0
Rangpur,Panchagarh,Panchagarh Sadar,Dhakkamara,2,2,0,0,0,0,2,0,0
Rangpur,Panchagarh,Panchagarh Sadar,Haribhasa,1,1,0,0,0,0,1,0,0
Rangpur,Panchagarh,Panchagarh Sadar,Garinabari,2,2,0,0,0,0,2,0,0
Rangpur,Panchagarh,Panchagarh Sadar,Amarkhana,1,1,0,0,0,0,1,0,0
Rangpur,Panchagarh,Panchagarh Sadar,Chaklarhat,2,2,0,0,0,1,1,0,0
Rangpur,Panchagarh,Panchagarh Sadar,Magura,1,1,0,0,0,0,1,0,0
Rangpur,Panchagarh,Panchagarh Sadar,Hafizabad,1,1,0,0,0,0,1,0,0
Rangpur,Panchagarh,Panchagarh Sadar,Satmara,1,1,0,0,0,0,1,0,0
Rangpur,Panchagarh,Panchagarh Sadar,Kamat Kajal Dighi,1,1,0,0,0,0,1,0,0
Rangpur,Panchagarh,Panchagarh Sadar,Panchagarh,0,0,0,0,0,0,0,0,0
Rangpur,Panchagarh,Panchagarh Sadar,Paurashava,0,0,0,0,0,0,0,0,0
Rangpur,Panchagarh,Panchagarh Sadar,###,12,12,0,0,0,1,11,0,0
Rangpur,Panchagarh,Debiganj,Debiganj,1,1,0,0,0,0,1,0,0
Rangpur,Panchagarh,Debiganj,Chilahati,1,1,0,0,0,0,1,0,0
Rangpur,Panchagarh,Debiganj,Dandapal,1,1,0,0,0,0,1,0,0
Rangpur,Panchagarh,Debiganj,Sonahar Mallikadaha,1,1,0,0,0,0,1,0,0
Rangpur,Panchagarh,Debiganj,Pamuli,2,2,0,0,0,0,2,0,0
Rangpur,Panchagarh,Debiganj,Debidoba,1,1,0,0,0,1,0,0,0
Rangpur,Panchagarh,Debiganj,Hazradanga,1,1,0,0,0,0,1,0,0
Rangpur,Panchagarh,Debiganj,Tepriganj,1,1,0,0,0,0,1,0,0
Rangpur,Panchagarh,Debiganj,Saldanga,0,0,0,0,0,0,0,0,0
Rangpur,Panchagarh,Debiganj,Sundar Dighi,0,0,0,0,0,0,0,0,0
Rangpur,Panchagarh,Debiganj,###,9,9,0,0,0,1,8,0,0
Rangpur,Panchagarh,Tentulia,Buraburi,1,1,0,0,0,0,1,0,0
Rangpur,Panchagarh,Tentulia,Salbahan,1,1,0,0,0,0,1,0,0
Rangpur,Panchagarh,Tentulia,Tentulia,1,1,0,0,0,0,1,0,0
Rangpur,Panchagarh,Tentulia,Tirnaihat,1,1,0,0,0,0,1,0,0
Rangpur,Panchagarh,Tentulia,Bhojanpur Debnagar,1,1,0,0,0,1,0,0,0
Rangpur,Panchagarh,Tentulia,Banglabandha,0,0,0,0,0,0,0,0,0
Rangpur,Panchagarh,Tentulia,Bhojanpur,0,0,0,0,0,0,0,0,0
Rangpur,Panchagarh,Tentulia,###,5,5,0,0,0,1,4,0,0
Rangpur,Panchagarh,Boda,Maidan Dighi,1,1,0,0,0,0,1,0,0
Rangpur,Panchagarh,Boda,Marea Bamanhat,1,1,0,0,0,1,0,0,0
Rangpur,Panchagarh,Boda,Sakoa,1,1,0,0,0,0,1,0,0
Rangpur,Panchagarh,Boda,Benghari Banagram,1,1,0,0,0,0,1,0,0
Rangpur,Panchagarh,Boda,Panchpir,1,1,0,0,0,0,1,0,0
Rangpur,Panchagarh,Boda,Chandanbari,1,1,0,0,0,1,0,0,0
Rangpur,Panchagarh,Boda,Jhalaishalsiri,1,1,0,0,0,0,1,0,0
Rangpur,Panchagarh,Boda,Paurashava,1,1,0,0,0,0,1,0,0
Rangpur,Panchagarh,Boda,Bara Shashi,0,0,0,0,0,0,0,0,0
Rangpur,Panchagarh,Boda,Boda,0,0,0,0,0,0,0,0,0
Rangpur,Panchagarh,Boda,Kajal Dighi Kaliganj,0,0,0,0,0,0,0,0,0
Rangpur,Panchagarh,Boda,###,8,8,0,0,0,2,6,0,0
Rangpur,Panchagarh,Atwari,Alowa Khowa,1,1,0,0,0,0,1,0,0
Rangpur,Panchagarh,Atwari,Radhanagar,1,1,0,0,0,0,1,0,0
Rangpur,Panchagarh,Atwari,Balarampur,1,1,0,0,0,0,1,0,0
Rangpur,Panchagarh,Atwari,Taria,1,1,0,0,0,0,1,0,0
Rangpur,Panchagarh,Atwari,Mirzapur,1,1,0,0,0,0,1,0,0
Rangpur,Panchagarh,Atwari,Dhamor,0,0,0,0,0,0,0,0,0
Rangpur,Panchagarh,Atwari,###,5,5,0,0,0,0,5,0,0
Rangpur,Panchagarh,###,###,39,39,0,0,0,5,34,0,0
Rangpur,Thakurgaon,Thakurgaon Sadar,Ruhea,1,1,0,0,0,0,1,0,0
Rangpur,Thakurgaon,Thakurgaon Sadar,Auliapur,1,1,0,0,0,0,1,0,0
Rangpur,Thakurgaon,Thakurgaon Sadar,Paurashava,2,2,0,0,0,0,2,0,0
Rangpur,Thakurgaon,Thakurgaon Sadar,Rajagaon,1,1,0,0,0,0,1,0,0
Rangpur,Thakurgaon,Thakurgaon Sadar,Mohammadpur,1,1,0,0,0,0,1,0,0
Rangpur,Thakurgaon,Thakurgaon Sadar,Gareya,1,1,0,0,0,0,1,0,0
Rangpur,Thakurgaon,Thakurgaon Sadar,Balia,1,1,0,0,0,0,1,0,0
Rangpur,Thakurgaon,Thakurgaon Sadar,Roypur,1,1,0,0,0,0,1,0,0
Rangpur,Thakurgaon,Thakurgaon Sadar,Jagannathpur,1,1,0,0,0,0,1,0,0
Rangpur,Thakurgaon,Thakurgaon Sadar,Nargun,1,0,1,1,0,0,0,0,0
Rangpur,Thakurgaon,Thakurgaon Sadar,Chilarang,1,1,0,0,0,0,1,0,0
Rangpur,Thakurgaon,Thakurgaon Sadar,Akcha,1,1,0,0,0,0,1,0,0
Rangpur,Thakurgaon,Thakurgaon Sadar,Akhanagar,0,0,0,0,0,0,0,0,0
Rangpur,Thakurgaon,Thakurgaon Sadar,Baragaon,0,0,0,0,0,0,0,0,0
Rangpur,Thakurgaon,Thakurgaon Sadar,Begunbari,0,0,0,0,0,0,0,0,0
Rangpur,Thakurgaon,Thakurgaon Sadar,Debipur,0,0,0,0,0,0,0,0,0
Rangpur,Thakurgaon,Thakurgaon Sadar,Jamalpur,0,0,0,0,0,0,0,0,0
Rangpur,Thakurgaon,Thakurgaon Sadar,Rahimanpur,0,0,0,0,0,0,0,0,0
Rangpur,Thakurgaon,Thakurgaon Sadar,Salandar,0,0,0,0,0,0,0,0,0
Rangpur,Thakurgaon,Thakurgaon Sadar,Sukhanpukhari,0,0,0,0,0,0,0,0,0
Rangpur,Thakurgaon,Thakurgaon Sadar,###,13,12,1,1,0,0,12,0,0
Rangpur,Thakurgaon,Pirganj,Saidpur,1,1,0,0,0,0,1,0,0
Rangpur,Thakurgaon,Pirganj,Jabarhat,1,1,0,0,0,0,1,0,0
Rangpur,Thakurgaon,Pirganj,Bairchuna,1,1,0,0,0,0,1,0,0
Rangpur,Thakurgaon,Pirganj,Daulatpur,1,1,0,0,0,0,1,0,0
Rangpur,Thakurgaon,Pirganj,Sengaon,1,1,0,0,0,0,1,0,0
Rangpur,Thakurgaon,Pirganj,Paurashava,2,2,0,0,0,0,2,0,0
Rangpur,Thakurgaon,Pirganj,Bhomradaha,1,1,0,0,0,0,1,0,0
Rangpur,Thakurgaon,Pirganj,Hajipur,1,1,0,0,0,1,0,0,0
Rangpur,Thakurgaon,Pirganj,Khangaon,1,1,0,0,0,0,1,0,0
Rangpur,Thakurgaon,Pirganj,Kusha Raniganj,0,0,0,0,0,0,0,0,0
Rangpur,Thakurgaon,Pirganj,Pirganj,0,0,0,0,0,0,0,0,0
Rangpur,Thakurgaon,Pirganj,###,10,10,0,0,0,1,9,0,0
Rangpur,Thakurgaon,Baliadangi,Barabari,1,1,0,0,0,0,1,0,0
Rangpur,Thakurgaon,Baliadangi,Dhantala,1,1,0,0,0,0,1,0,0
Rangpur,Thakurgaon,Baliadangi,Charol,1,1,0,0,0,0,1,0,0
Rangpur,Thakurgaon,Baliadangi,Paria,2,2,0,0,0,1,1,0,0
Rangpur,Thakurgaon,Baliadangi,Bara Palashbari,1,1,0,0,0,0,1,0,0
Rangpur,Thakurgaon,Baliadangi,Duosuo,1,1,0,0,0,0,1,0,0
Rangpur,Thakurgaon,Baliadangi,Bhanor,1,1,0,0,0,0,1,0,0
Rangpur,Thakurgaon,Baliadangi,Amjankhore,0,0,0,0,0,0,0,0,0
Rangpur,Thakurgaon,Baliadangi,###,8,8,0,0,0,1,7,0,0
Rangpur,Thakurgaon,Ranisankail,Lehemba,1,1,0,0,0,0,1,0,0
Rangpur,Thakurgaon,Ranisankail,Rator,1,1,0,0,0,0,1,0,0
Rangpur,Thakurgaon,Ranisankail,Nekmarad,1,1,0,0,0,0,1,0,0
Rangpur,Thakurgaon,Ranisankail,Bachor,1,1,0,0,0,0,1,0,0
Rangpur,Thakurgaon,Ranisankail,Hossain Gaon,1,1,0,0,0,0,1,0,0
Rangpur,Thakurgaon,Ranisankail,Dharmagarh,1,1,0,0,0,0,1,0,0
Rangpur,Thakurgaon,Ranisankail,Paurashava,1,1,0,0,0,0,1,0,0
Rangpur,Thakurgaon,Ranisankail,Kashipur,0,0,0,0,0,0,0,0,0
Rangpur,Thakurgaon,Ranisankail,Nonduar,0,0,0,0,0,0,0,0,0
Rangpur,Thakurgaon,Ranisankail,###,7,7,0,0,0,0,7,0,0
Rangpur,Thakurgaon,Haripur,Bhaturia,1,1,0,0,0,0,1,0,0
Rangpur,Thakurgaon,Haripur,Amgaon,1,1,0,0,0,0,1,0,0
Rangpur,Thakurgaon,Haripur,Gedura,1,1,0,0,0,0,1,0,0
Rangpur,Thakurgaon,Haripur,Bakua,1,1,0,0,0,1,0,0,0
Rangpur,Thakurgaon,Haripur,Haripur,2,2,0,0,0,1,1,0,0
Rangpur,Thakurgaon,Haripur,Dangi Para,1,1,0,0,0,0,1,0,0
Rangpur,Thakurgaon,Haripur,###,7,7,0,0,0,2,5,0,0
Rangpur,Thakurgaon,###,###,45,44,1,1,0,4,40,0,0
Rangpur,###,###,###,502,496,6,6,0,103,381,9,3
Rajshahi,Naogaon,Patnitala,Dibar,1,1,0,0,0,0,0,0,1
Rajshahi,Naogaon,Patnitala,Matindhar,1,1,0,0,0,0,1,0,0
Rajshahi,Naogaon,Patnitala,Krishnapur,1,1,0,0,0,0,1,0,0
Rajshahi,Naogaon,Patnitala,Ghoshnagar,2,2,0,0,0,0,2,0,0
Rajshahi,Naogaon,Patnitala,Patnitala,2,2,0,0,0,0,2,0,0
Rajshahi,Naogaon,Patnitala,Patichara,1,1,0,0,0,0,1,0,0
Rajshahi,Naogaon,Patnitala,Akbarpur,1,1,0,0,0,0,1,0,0
Rajshahi,Naogaon,Patnitala,Nozipur Paurashava,1,1,0,0,0,0,1,0,0
Rajshahi,Naogaon,Patnitala,Amair,0,0,0,0,0,0,0,0,0
Rajshahi,Naogaon,Patnitala,Nazipur,0,0,0,0,0,0,0,0,0
Rajshahi,Naogaon,Patnitala,Nirmail,0,0,0,0,0,0,0,0,0
Rajshahi,Naogaon,Patnitala,Shihara,0,0,0,0,0,0,0,0,0
Rajshahi,Naogaon,Patnitala,###,10,10,0,0,0,0,9,0,1
Rajshahi,Naogaon,Porsha,Tentulia,1,1,0,0,0,0,0,0,1
Rajshahi,Naogaon,Porsha,Ghatnagar,1,1,0,0,0,0,0,0,1
Rajshahi,Naogaon,Porsha,Chhaor,1,1,0,0,0,0,0,1,0
Rajshahi,Naogaon,Porsha,Ganguria,1,1,0,0,0,0,1,0,0
Rajshahi,Naogaon,Porsha,Masidpur,2,2,0,0,0,0,2,0,0
Rajshahi,Naogaon,Porsha,Nithpur,0,0,0,0,0,0,0,0,0
Rajshahi,Naogaon,Porsha,###,6,6,0,0,0,0,3,1,2
Rajshahi,Naogaon,Sapahar,Sapahar,2,2,0,0,0,0,0,2,0
Rajshahi,Naogaon,Sapahar,Goala,1,1,0,0,0,0,0,1,0
Rajshahi,Naogaon,Sapahar,Tilna,1,1,0,0,0,0,1,0,0
Rajshahi,Naogaon,Sapahar,Shiranti,1,1,0,0,0,0,1,0,0
Rajshahi,Naogaon,Sapahar,Aihai,0,0,0,0,0,0,0,0,0
Rajshahi,Naogaon,Sapahar,Pathari,0,0,0,0,0,0,0,0,0
Rajshahi,Naogaon,Sapahar,###,5,5,0,0,0,0,2,3,0
Rajshahi,Naogaon,Niamatpur,Rasulpur,2,2,0,0,0,0,2,0,0
Rajshahi,Naogaon,Niamatpur,Chandan Nagar,1,1,0,0,0,0,1,0,0
Rajshahi,Naogaon,Niamatpur,Bhabicha,2,2,0,0,0,0,2,0,0
Rajshahi,Naogaon,Niamatpur,Parail,1,1,0,0,0,0,1,0,0
Rajshahi,Naogaon,Niamatpur,Sreemantapur,1,1,0,0,0,0,1,0,0
Rajshahi,Naogaon,Niamatpur,Niamatpur,1,1,0,0,0,0,1,0,0
Rajshahi,Naogaon,Niamatpur,Bahadurpur,0,0,0,0,0,0,0,0,0
Rajshahi,Naogaon,Niamatpur,Hajinagar,0,0,0,0,0,0,0,0,0
Rajshahi,Naogaon,Niamatpur,###,8,8,0,0,0,0,8,0,0
Rajshahi,Naogaon,Manda,Kusumba,1,1,0,0,0,0,1,0,0
Rajshahi,Naogaon,Manda,Kalikapur,1,1,0,0,0,0,1,0,0
Rajshahi,Naogaon,Manda,Prasadpur,1,1,0,0,0,0,1,0,0
Rajshahi,Naogaon,Manda,Kashab,1,1,0,0,0,0,1,0,0
Rajshahi,Naogaon,Manda,Bharso,1,1,0,0,0,0,1,0,0
Rajshahi,Naogaon,Manda,Mainani,1,1,0,0,0,0,1,0,0
Rajshahi,Naogaon,Manda,Ganeshpur,1,1,0,0,0,0,1,0,0
Rajshahi,Naogaon,Manda,Nurullabad,1,1,0,0,0,0,1,0,0
Rajshahi,Naogaon,Manda,Bhalain,0,0,0,0,0,0,0,0,0
Rajshahi,Naogaon,Manda,Bishnupur,0,0,0,0,0,0,0,0,0
Rajshahi,Naogaon,Manda,Kanso Para,0,0,0,0,0,0,0,0,0
Rajshahi,Naogaon,Manda,Manda,0,0,0,0,0,0,0,0,0
Rajshahi,Naogaon,Manda,Paranpur,0,0,0,0,0,0,0,0,0
Rajshahi,Naogaon,Manda,Tentulia,0,0,0,0,0,0,0,0,0
Rajshahi,Naogaon,Manda,###,8,8,0,0,0,0,8,0,0
Rajshahi,Naogaon,Badalgachhi,Bilasbari,2,2,0,0,0,1,1,0,0
Rajshahi,Naogaon,Badalgachhi,Balubhara,1,1,0,0,0,0,1,0,0
Rajshahi,Naogaon,Badalgachhi,Pahar Pur,1,1,0,0,0,0,1,0,0
Rajshahi,Naogaon,Badalgachhi,Kola,1,1,0,0,0,0,1,0,0
Rajshahi,Naogaon,Badalgachhi,Badalgachhi,2,2,0,0,0,0,2,0,0
Rajshahi,Naogaon,Badalgachhi,Mithapur,1,1,0,0,0,0,1,0,0
Rajshahi,Naogaon,Badalgachhi,Mathurapur,1,1,0,0,0,0,1,0,0
Rajshahi,Naogaon,Badalgachhi,Adhaipur,0,0,0,0,0,0,0,0,0
Rajshahi,Naogaon,Badalgachhi,###,9,9,0,0,0,1,8,0,0
Rajshahi,Naogaon,Atrai,Hatkalu Para,1,1,0,0,0,0,1,0,0
Rajshahi,Naogaon,Atrai,Panchupur,2,2,0,0,0,0,2,0,0
Rajshahi,Naogaon,Atrai,Bhopara,1,1,0,0,0,0,1,0,0
Rajshahi,Naogaon,Atrai,Kalikapur,2,2,0,0,0,0,2,0,0
Rajshahi,Naogaon,Atrai,Ahsanganj,2,2,0,0,0,0,2,0,0
Rajshahi,Naogaon,Atrai,Maniari,1,1,0,0,0,0,1,0,0
Rajshahi,Naogaon,Atrai,Bisha,0,0,0,0,0,0,0,0,0
Rajshahi,Naogaon,Atrai,Sahagola,0,0,0,0,0,0,0,0,0
Rajshahi,Naogaon,Atrai,###,9,9,0,0,0,0,9,0,0
Rajshahi,Naogaon,Dhamoirhat,Alampur,2,2,0,0,0,0,2,0,0
Rajshahi,Naogaon,Dhamoirhat,Dhamoirhat Paurashava,1,1,0,0,0,0,1,0,0
Rajshahi,Naogaon,Dhamoirhat,Dhamoirhat,1,1,0,0,0,0,1,0,0
Rajshahi,Naogaon,Dhamoirhat,Isabpur,1,1,0,0,0,0,1,0,0
Rajshahi,Naogaon,Dhamoirhat,Khelna,2,2,0,0,0,0,2,0,0
Rajshahi,Naogaon,Dhamoirhat,Jahanpur,1,1,0,0,0,0,1,0,0
Rajshahi,Naogaon,Dhamoirhat,Agra Digun,0,0,0,0,0,0,0,0,0
Rajshahi,Naogaon,Dhamoirhat,Aranagar,0,0,0,0,0,0,0,0,0
Rajshahi,Naogaon,Dhamoirhat,Omar,0,0,0,0,0,0,0,0,0
Rajshahi,Naogaon,Dhamoirhat,###,8,8,0,0,0,0,8,0,0
Rajshahi,Naogaon,Naogaon Sadar,Chandipur,1,1,0,0,0,0,1,0,0
Rajshahi,Naogaon,Naogaon Sadar,Hapania,1,1,0,0,0,0,1,0,0
Rajshahi,Naogaon,Naogaon Sadar,Kirtipur,1,1,0,0,0,0,1,0,0
Rajshahi,Naogaon,Naogaon Sadar,Naogaon Paurashava,3,3,0,0,0,0,3,0,0
Rajshahi,Naogaon,Naogaon Sadar,Hashaighari,1,1,0,0,0,0,1,0,0
Rajshahi,Naogaon,Naogaon Sadar,Tilakpur,1,1,0,0,0,0,1,0,0
Rajshahi,Naogaon,Naogaon Sadar,Barshail,1,1,0,0,0,0,1,0,0
Rajshahi,Naogaon,Naogaon Sadar,Dubalhati,1,1,0,0,0,0,1,0,0
Rajshahi,Naogaon,Naogaon Sadar,Baktiarpur,1,1,0,0,0,0,1,0,0
Rajshahi,Naogaon,Naogaon Sadar,Balihar,0,0,0,0,0,0,0,0,0
Rajshahi,Naogaon,Naogaon Sadar,Boalia,0,0,0,0,0,0,0,0,0
Rajshahi,Naogaon,Naogaon Sadar,Sailgachhi,0,0,0,0,0,0,0,0,0
Rajshahi,Naogaon,Naogaon Sadar,Sekherpur,0,0,0,0,0,0,0,0,0
Rajshahi,Naogaon,Naogaon Sadar,###,11,11,0,0,0,0,11,0,0
Rajshahi,Naogaon,Mahadebpur,Khajur,3,3,0,0,0,0,3,0,0
Rajshahi,Naogaon,Mahadebpur,Safapur,1,1,0,0,0,0,1,0,0
Rajshahi,Naogaon,Mahadebpur,Chandas,2,2,0,0,0,0,2,0,0
Rajshahi,Naogaon,Mahadebpur,Enayetpur,1,1,0,0,0,0,1,0,0
Rajshahi,Naogaon,Mahadebpur,Cheragpur,1,1,0,0,0,0,1,0,0
Rajshahi,Naogaon,Mahadebpur,Hatur,1,1,0,0,0,0,1,0,0
Rajshahi,Naogaon,Mahadebpur,Bhimpur,0,0,0,0,0,0,0,0,0
Rajshahi,Naogaon,Mahadebpur,Mahadebpur,0,0,0,0,0,0,0,0,0
Rajshahi,Naogaon,Mahadebpur,Roygaon,0,0,0,0,0,0,0,0,0
Rajshahi,Naogaon,Mahadebpur,Uttargram,0,0,0,0,0,0,0,0,0
Rajshahi,Naogaon,Mahadebpur,###,9,9,0,0,0,0,9,0,0
Rajshahi,Naogaon,Raninagar,Gona,2,2,0,0,0,0,2,0,0
Rajshahi,Naogaon,Raninagar,Parail,1,1,0,0,0,0,1,0,0
Rajshahi,Naogaon,Raninagar,Kaligram,1,1,0,0,0,0,1,0,0
Rajshahi,Naogaon,Raninagar,Kashimpur,1,1,0,0,0,0,1,0,0
Rajshahi,Naogaon,Raninagar,Raninagar,1,1,0,0,0,0,1,0,0
Rajshahi,Naogaon,Raninagar,Mirat,1,1,0,0,0,0,1,0,0
Rajshahi,Naogaon,Raninagar,Ekdala,1,1,0,0,0,0,1,0,0
Rajshahi,Naogaon,Raninagar,Bargachha,0,0,0,0,0,0,0,0,0
Rajshahi,Naogaon,Raninagar,###,8,8,0,0,0,0,8,0,0
Rajshahi,Naogaon,###,###,91,91,0,0,0,1,83,4,3
Rajshahi,Sirajganj,Tarash,Tarash,3,3,0,0,0,0,2,0,1
Rajshahi,Sirajganj,Tarash,Deshigram,1,1,0,0,0,0,1,0,0
Rajshahi,Sirajganj,Tarash,Talam,1,1,0,0,0,0,1,0,0
Rajshahi,Sirajganj,Tarash,Baruhas,2,2,0,0,0,0,2,0,0
Rajshahi,Sirajganj,Tarash,Magura Binod,1,1,0,0,0,0,1,0,0
Rajshahi,Sirajganj,Tarash,Madhainagar,1,1,0,0,0,0,1,0,0
Rajshahi,Sirajganj,Tarash,Naogaon,1,1,0,0,0,0,1,0,0
Rajshahi,Sirajganj,Tarash,Saguna,0,0,0,0,0,0,0,0,0
Rajshahi,Sirajganj,Tarash,###,10,10,0,0,0,0,9,0,1
Rajshahi,Sirajganj,Royganj,Chandaikona,2,2,0,0,0,0,2,0,0
Rajshahi,Sirajganj,Royganj,Dhamainagar,1,1,0,0,0,0,1,0,0
Rajshahi,Sirajganj,Royganj,Dhubil,1,1,0,0,0,0,1,0,0
Rajshahi,Sirajganj,Royganj,Brahmagachha,1,1,0,0,0,0,1,0,0
Rajshahi,Sirajganj,Royganj,Sonakhara,1,1,0,0,0,0,1,0,0
Rajshahi,Sirajganj,Royganj,Nalka,1,1,0,0,0,0,1,0,0
Rajshahi,Sirajganj,Royganj,Pangashi,1,1,0,0,0,0,1,0,0
Rajshahi,Sirajganj,Royganj,Ghurka,1,1,0,0,0,0,1,0,0
Rajshahi,Sirajganj,Royganj,Dhangara,0,0,0,0,0,0,0,0,0
Rajshahi,Sirajganj,Royganj,Royganj Paurashava,0,0,0,0,0,0,0,0,0
Rajshahi,Sirajganj,Royganj,###,9,9,0,0,0,0,9,0,0
Rajshahi,Sirajganj,Kazipur,Gandail,1,1,0,0,0,0,1,0,0
Rajshahi,Sirajganj,Kazipur,Natuar Para,2,2,0,0,0,0,2,0,0
Rajshahi,Sirajganj,Kazipur,Khas Rajbari,1,1,0,0,0,0,1,0,0
Rajshahi,Sirajganj,Kazipur,Subhagachha,1,1,0,0,0,0,1,0,0
Rajshahi,Sirajganj,Kazipur,Char Girish,1,1,0,0,0,1,0,0,0
Rajshahi,Sirajganj,Kazipur,Sonamukhi,1,1,0,0,0,0,1,0,0
Rajshahi,Sirajganj,Kazipur,Chalitadanga,2,2,0,0,0,0,2,0,0
Rajshahi,Sirajganj,Kazipur,Kazipur,1,1,0,0,0,1,0,0,0
Rajshahi,Sirajganj,Kazipur,Kazipur Paurashava,0,0,0,0,0,0,0,0,0
Rajshahi,Sirajganj,Kazipur,Maijbari,0,0,0,0,0,0,0,0,0
Rajshahi,Sirajganj,Kazipur,Mansur Nagar,0,0,0,0,0,0,0,0,0
Rajshahi,Sirajganj,Kazipur,Nishchintapur,0,0,0,0,0,0,0,0,0
Rajshahi,Sirajganj,Kazipur,Tekani,0,0,0,0,0,0,0,0,0
Rajshahi,Sirajganj,Kazipur,###,10,10,0,0,0,2,8,0,0
Rajshahi,Sirajganj,Chauhali,Khas Pukuria,1,1,0,0,0,0,1,0,0
Rajshahi,Sirajganj,Chauhali,Sthal,1,1,0,0,0,1,0,0,0
Rajshahi,Sirajganj,Chauhali,Gharjan,1,1,0,0,0,0,1,0,0
Rajshahi,Sirajganj,Chauhali,Omarpur,1,1,0,0,0,0,1,0,0
Rajshahi,Sirajganj,Chauhali,Khas Kaulia,2,2,0,0,0,1,1,0,0
Rajshahi,Sirajganj,Chauhali,Sadia Chandpur,1,1,0,0,0,0,1,0,0
Rajshahi,Sirajganj,Chauhali,Bagutia,0,0,0,0,0,0,0,0,0
Rajshahi,Sirajganj,Chauhali,###,7,7,0,0,0,2,5,0,0
Rajshahi,Sirajganj,Belkuchi,Bhangabari,3,2,1,1,0,1,1,0,0
Rajshahi,Sirajganj,Belkuchi,Dhukaria Bera,1,1,0,0,0,0,1,0,0
Rajshahi,Sirajganj,Belkuchi,Daulatpur,2,2,0,0,0,0,2,0,0
Rajshahi,Sirajganj,Belkuchi,Rajapur,2,2,0,0,0,0,2,0,0
Rajshahi,Sirajganj,Belkuchi,Bara Dhul,0,0,0,0,0,0,0,0,0
Rajshahi,Sirajganj,Belkuchi,Belkuchi,0,0,0,0,0,0,0,0,0
Rajshahi,Sirajganj,Belkuchi,Belkuchi Paurashava,0,0,0,0,0,0,0,0,0
Rajshahi,Sirajganj,Belkuchi,###,8,7,1,1,0,1,6,0,0
Rajshahi,Sirajganj,Shahjadpur,Jalalpur,1,1,0,0,0,0,1,0,0
Rajshahi,Sirajganj,Shahjadpur,Kayempur,1,1,0,0,0,0,1,0,0
Rajshahi,Sirajganj,Shahjadpur,Khukni,1,1,0,0,0,1,0,0,0
Rajshahi,Sirajganj,Shahjadpur,Shahjadpur Paurashava,1,1,0,0,0,1,0,0,0
Rajshahi,Sirajganj,Shahjadpur,Garadaha,1,1,0,0,0,0,1,0,0
Rajshahi,Sirajganj,Shahjadpur,Beltail,1,1,0,0,0,0,1,0,0
Rajshahi,Sirajganj,Shahjadpur,Rupabati,1,0,1,1,0,0,0,0,0
Rajshahi,Sirajganj,Shahjadpur,Porjana,1,1,0,0,0,0,1,0,0
Rajshahi,Sirajganj,Shahjadpur,Potajia,1,1,0,0,0,0,1,0,0
Rajshahi,Sirajganj,Shahjadpur,Gala,1,1,0,0,0,0,1,0,0
Rajshahi,Sirajganj,Shahjadpur,Narnia,1,1,0,0,0,0,1,0,0
Rajshahi,Sirajganj,Shahjadpur,Habibulla Nagar,0,0,0,0,0,0,0,0,0
Rajshahi,Sirajganj,Shahjadpur,Kaijuri,0,0,0,0,0,0,0,0,0
Rajshahi,Sirajganj,Shahjadpur,Sonatani,0,0,0,0,0,0,0,0,0
Rajshahi,Sirajganj,Shahjadpur,###,11,10,1,1,0,2,8,0,0
Rajshahi,Sirajganj,Ullah Para,Mohanpur,1,1,0,0,0,0,1,0,0
Rajshahi,Sirajganj,Ullah Para,Hatikumrul,1,1,0,0,0,0,1,0,0
Rajshahi,Sirajganj,Ullah Para,Durganagar,1,1,0,0,0,0,1,0,0
Rajshahi,Sirajganj,Ullah Para,Purnimaganti,2,2,0,0,0,0,2,0,0
Rajshahi,Sirajganj,Ullah Para,Ullah Para,1,1,0,0,0,0,0,0,1
Rajshahi,Sirajganj,Ullah Para,Ramkrishnapur,2,2,0,0,0,0,2,0,0
Rajshahi,Sirajganj,Ullah Para,Barahar,1,1,0,0,0,0,1,0,0
Rajshahi,Sirajganj,Ullah Para,Bara Pangashi,1,1,0,0,0,0,1,0,0
Rajshahi,Sirajganj,Ullah Para,Bangala,1,1,0,0,0,0,1,0,0
Rajshahi,Sirajganj,Ullah Para,Pancha Krushi,0,0,0,0,0,0,0,0,0
Rajshahi,Sirajganj,Ullah Para,Salanga,0,0,0,0,0,0,0,0,0
Rajshahi,Sirajganj,Ullah Para,Salap,0,0,0,0,0,0,0,0,0
Rajshahi,Sirajganj,Ullah Para,Udhunia,0,0,0,0,0,0,0,0,0
Rajshahi,Sirajganj,Ullah Para,Ullah Para Paurashava,0,0,0,0,0,0,0,0,0
Rajshahi,Sirajganj,Ullah Para,###,11,11,0,0,0,0,10,0,1
Rajshahi,Sirajganj,Sirajganj Sadar,Sirajganj Paurashava,2,2,0,0,0,1,0,0,1
Rajshahi,Sirajganj,Sirajganj Sadar,Chhangachha,3,3,0,0,0,0,3,0,0
Rajshahi,Sirajganj,Sirajganj Sadar,Kalia Haripur,1,1,0,0,0,0,1,0,0
Rajshahi,Sirajganj,Sirajganj Sadar,Saidabad,1,1,0,0,0,0,1,0,0
Rajshahi,Sirajganj,Sirajganj Sadar,Kaoakola,1,1,0,0,0,0,1,0,0
Rajshahi,Sirajganj,Sirajganj Sadar,Shialkul,2,2,0,0,0,1,1,0,0
Rajshahi,Sirajganj,Sirajganj Sadar,Ratankandi,2,2,0,0,0,1,1,0,0
Rajshahi,Sirajganj,Sirajganj Sadar,Bahuli,1,1,0,0,0,0,1,0,0
Rajshahi,Sirajganj,Sirajganj Sadar,Baghbati,1,1,0,0,0,0,1,0,0
Rajshahi,Sirajganj,Sirajganj Sadar,Khoksabari,0,0,0,0,0,0,0,0,0
Rajshahi,Sirajganj,Sirajganj Sadar,Mechhra,0,0,0,0,0,0,0,0,0
Rajshahi,Sirajganj,Sirajganj Sadar,###,14,14,0,0,0,3,10,0,1
Rajshahi,Sirajganj,Kamarkhanda,Bhadraghat,2,2,0,0,0,0,2,0,0
Rajshahi,Sirajganj,Kamarkhanda,Roy Daulatpur,2,2,0,0,0,0,2,0,0
Rajshahi,Sirajganj,Kamarkhanda,Jamtail,3,3,0,0,0,0,2,0,1
Rajshahi,Sirajganj,Kamarkhanda,Jhawail,1,1,0,0,0,0,1,0,0
Rajshahi,Sirajganj,Kamarkhanda,###,8,8,0,0,0,0,7,0,1
Rajshahi,Sirajganj,###,###,88,86,2,2,0,10,72,0,4
Rajshahi,Natore,Gurudaspur,Gurudaspur Paurashava,2,2,0,0,0,0,1,1,0
Rajshahi,Natore,Gurudaspur,Chapila,1,1,0,0,0,0,1,0,0
Rajshahi,Natore,Gurudaspur,Nazirpur,3,3,0,0,0,0,3,0,0
Rajshahi,Natore,Gurudaspur,Biaghat,1,1,0,0,0,0,1,0,0
Rajshahi,Natore,Gurudaspur,Moshinda,1,1,0,0,0,0,1,0,0
Rajshahi,Natore,Gurudaspur,Dharabarisha,1,1,0,0,0,0,1,0,0
Rajshahi,Natore,Gurudaspur,Khubjipur,0,0,0,0,0,0,0,0,0
Rajshahi,Natore,Gurudaspur,###,9,9,0,0,0,0,8,1,0
Rajshahi,Natore,Bagati Para,Jamnagar,1,1,0,0,0,0,1,0,0
Rajshahi,Natore,Bagati Para,Bagati Para,2,2,0,0,0,0,2,0,0
Rajshahi,Natore,Bagati Para,Fhaguradiar,1,1,0,0,0,0,1,0,0
Rajshahi,Natore,Bagati Para,Dayarampur,1,1,0,0,0,0,1,0,0
Rajshahi,Natore,Bagati Para,Panka,2,2,0,0,0,0,2,0,0
Rajshahi,Natore,Bagati Para,Bagatipara Paurashava,1,1,0,0,0,0,1,0,0
Rajshahi,Natore,Bagati Para,###,8,8,0,0,0,0,8,0,0
Rajshahi,Natore,Natore Sadar,Kafuria,2,2,0,0,0,0,2,0,0
Rajshahi,Natore,Natore Sadar,Naldanga Paurashava,1,1,0,0,0,0,1,0,0
Rajshahi,Natore,Natore Sadar,Halsa,1,1,0,0,0,0,1,0,0
Rajshahi,Natore,Natore Sadar,Piprul,1,1,0,0,0,0,1,0,0
Rajshahi,Natore,Natore Sadar,Dighapatia,2,2,0,0,0,0,2,0,0
Rajshahi,Natore,Natore Sadar,Bara Harishpur,1,1,0,0,0,0,1,0,0
Rajshahi,Natore,Natore Sadar,Bipra Belgharia,1,1,0,0,0,0,1,0,0
Rajshahi,Natore,Natore Sadar,Natore Paurashava,2,2,0,0,0,0,2,0,0
Rajshahi,Natore,Natore Sadar,Chhatni,1,1,0,0,0,0,1,0,0
Rajshahi,Natore,Natore Sadar,Lakshmipur Kholabaria,1,1,0,0,0,0,1,0,0
Rajshahi,Natore,Natore Sadar,Brahmapur,0,0,0,0,0,0,0,0,0
Rajshahi,Natore,Natore Sadar,Khajuria,0,0,0,0,0,0,0,0,0
Rajshahi,Natore,Natore Sadar,Madhnagar,0,0,0,0,0,0,0,0,0
Rajshahi,Natore,Natore Sadar,Tebaria,0,0,0,0,0,0,0,0,0
Rajshahi,Natore,Natore Sadar,###,13,13,0,0,0,0,13,0,0
Rajshahi,Natore,Lalpur,Lalpur,1,1,0,0,0,0,1,0,0
Rajshahi,Natore,Lalpur,Ishwardi,1,1,0,0,0,0,1,0,0
Rajshahi,Natore,Lalpur,Durduria,1,1,0,0,0,0,1,0,0
Rajshahi,Natore,Lalpur,Walia,1,1,0,0,0,0,1,0,0
Rajshahi,Natore,Lalpur,Bilmaria,1,1,0,0,0,0,1,0,0
Rajshahi,Natore,Lalpur,Kadam Chilan,1,1,0,0,0,0,1,0,0
Rajshahi,Natore,Lalpur,Gopalpur (Lalpur) Paurashav,1,1,0,0,0,0,1,0,0
Rajshahi,Natore,Lalpur,Arbab,0,0,0,0,0,0,0,0,0
Rajshahi,Natore,Lalpur,Arjunpur Boromhati,0,0,0,0,0,0,0,0,0
Rajshahi,Natore,Lalpur,Changdhupail,0,0,0,0,0,0,0,0,0
Rajshahi,Natore,Lalpur,Duaria,0,0,0,0,0,0,0,0,0
Rajshahi,Natore,Lalpur,###,7,7,0,0,0,0,7,0,0
Rajshahi,Natore,Baraigram,Joari,1,1,0,0,0,0,1,0,0
Rajshahi,Natore,Baraigram,Banpara Paurashava,1,1,0,0,0,0,1,0,0
Rajshahi,Natore,Baraigram,Baraigram Paurashava,2,2,0,0,0,0,2,0,0
Rajshahi,Natore,Baraigram,Chandi,1,1,0,0,0,0,1,0,0
Rajshahi,Natore,Baraigram,Gopalpur,1,1,0,0,0,0,1,0,0
Rajshahi,Natore,Baraigram,Nagar,1,1,0,0,0,0,1,0,0
Rajshahi,Natore,Baraigram,Majgaon,1,1,0,0,0,0,1,0,0
Rajshahi,Natore,Baraigram,Baraigram,0,0,0,0,0,0,0,0,0
Rajshahi,Natore,Baraigram,Jonail,0,0,0,0,0,0,0,0,0
Rajshahi,Natore,Baraigram,###,8,8,0,0,0,0,8,0,0
Rajshahi,Natore,Singra,Hatiandaha,1,1,0,0,0,0,1,0,0
Rajshahi,Natore,Singra,Italy,2,2,0,0,0,0,2,0,0
Rajshahi,Natore,Singra,Sukash,1,1,0,0,0,0,1,0,0
Rajshahi,Natore,Singra,Chaugram,1,1,0,0,0,0,1,0,0
Rajshahi,Natore,Singra,Sherkole,1,1,0,0,0,0,1,0,0
Rajshahi,Natore,Singra,Singra Paurashava,1,1,0,0,0,0,1,0,0
Rajshahi,Natore,Singra,Chamari,0,0,0,0,0,0,0,0,0
Rajshahi,Natore,Singra,Chhatar Dighi,0,0,0,0,0,0,0,0,0
Rajshahi,Natore,Singra,Dahia,0,0,0,0,0,0,0,0,0
Rajshahi,Natore,Singra,Kalam,0,0,0,0,0,0,0,0,0
Rajshahi,Natore,Singra,Lalore,0,0,0,0,0,0,0,0,0
Rajshahi,Natore,Singra,Ramananda Khajura,0,0,0,0,0,0,0,0,0
Rajshahi,Natore,Singra,Tajpur,0,0,0,0,0,0,0,0,0
Rajshahi,Natore,Singra,###,7,7,0,0,0,0,7,0,0
Rajshahi,Natore,###,###,52,52,0,0,0,0,51,1,0
Rajshahi,Nawabganj,Gomastapur,Parbatipur,5,5,0,0,0,0,1,4,0
Rajshahi,Nawabganj,Gomastapur,Rahanpur Paurashava,1,1,0,0,0,0,0,1,0
Rajshahi,Nawabganj,Gomastapur,Chowdala,2,2,0,0,0,0,2,0,0
Rajshahi,Nawabganj,Gomastapur,Rohanpur,1,1,0,0,0,0,1,0,0
Rajshahi,Nawabganj,Gomastapur,Boalia,1,1,0,0,0,0,1,0,0
Rajshahi,Nawabganj,Gomastapur,Gomastapur,1,1,0,0,0,0,1,0,0
Rajshahi,Nawabganj,Gomastapur,Alinagar,1,1,0,0,0,0,0,1,0
Rajshahi,Nawabganj,Gomastapur,Bhangabaria,0,0,0,0,0,0,0,0,0
Rajshahi,Nawabganj,Gomastapur,Radhanagar,0,0,0,0,0,0,0,0,0
Rajshahi,Nawabganj,Gomastapur,###,12,12,0,0,0,0,6,6,0
Rajshahi,Nawabganj,Bholahat,Gohalbari,3,3,0,0,0,0,2,1,0
Rajshahi,Nawabganj,Bholahat,Daldali,1,1,0,0,0,0,1,0,0
Rajshahi,Nawabganj,Bholahat,Bholahat,1,1,0,0,0,0,1,0,0
Rajshahi,Nawabganj,Bholahat,Jambaria,1,1,0,0,0,0,1,0,0
Rajshahi,Nawabganj,Bholahat,###,6,6,0,0,0,0,5,1,0
Rajshahi,Nawabganj,Nachole,Nachole Paurashava,1,1,0,0,0,0,0,1,0
Rajshahi,Nawabganj,Nachole,Kasba,2,2,0,0,0,0,1,1,0
Rajshahi,Nawabganj,Nachole,Nizampur,3,3,0,0,0,0,2,1,0
Rajshahi,Nawabganj,Nachole,Fatehpur,3,3,0,0,0,0,3,0,0
Rajshahi,Nawabganj,Nachole,Nachole,1,1,0,0,0,0,1,0,0
Rajshahi,Nawabganj,Nachole,###,10,10,0,0,0,0,7,3,0
Rajshahi,Nawabganj,Shibganj,Mobarakpur,2,2,0,0,0,0,2,0,0
Rajshahi,Nawabganj,Shibganj,Naya Naobhanga,8,8,0,0,0,1,7,0,0
Rajshahi,Nawabganj,Shibganj,Daipukuria,1,1,0,0,0,0,1,0,0
Rajshahi,Nawabganj,Shibganj,Shibganj Paurashava,2,2,0,0,0,0,2,0,0
Rajshahi,Nawabganj,Shibganj,Shahbajpur,1,1,0,0,0,0,1,0,0
Rajshahi,Nawabganj,Shibganj,Ghorapakhia,1,1,0,0,0,0,1,0,0
Rajshahi,Nawabganj,Shibganj,Binodpur,2,2,0,0,0,0,1,1,0
Rajshahi,Nawabganj,Shibganj,Durlabhpur,3,3,0,0,0,0,3,0,0
Rajshahi,Nawabganj,Shibganj,Manakosa,2,2,0,0,0,0,2,0,0
Rajshahi,Nawabganj,Shibganj,Kansat,4,4,0,0,0,0,4,0,0
Rajshahi,Nawabganj,Shibganj,Panka,1,1,0,0,0,0,1,0,0
Rajshahi,Nawabganj,Shibganj,Uzirpur,1,1,0,0,0,0,1,0,0
Rajshahi,Nawabganj,Shibganj,Dhainagar,2,2,0,0,0,1,1,0,0
Rajshahi,Nawabganj,Shibganj,Shyampur,4,4,0,0,0,1,3,0,0
Rajshahi,Nawabganj,Shibganj,Chak Kirti,1,1,0,0,0,0,1,0,0
Rajshahi,Nawabganj,Shibganj,Satrujitpur,1,1,0,0,0,0,1,0,0
Rajshahi,Nawabganj,Shibganj,###,36,36,0,0,0,3,32,1,0
Rajshahi,Nawabganj,Nawabganj Sadar,Jhilim,20,20,0,0,0,0,17,3,0
Rajshahi,Nawabganj,Nawabganj Sadar,Gobratala,9,9,0,0,0,0,9,0,0
Rajshahi,Nawabganj,Nawabganj Sadar,Shahjahanpur,4,4,0,0,0,0,4,0,0
Rajshahi,Nawabganj,Nawabganj Sadar,Debinagar,3,3,0,0,0,0,3,0,0
Rajshahi,Nawabganj,Nawabganj Sadar,Sundarpur,5,5,0,0,0,1,4,0,0
Rajshahi,Nawabganj,Nawabganj Sadar,Char Bagdanga,2,2,0,0,0,0,2,0,0
Rajshahi,Nawabganj,Nawabganj Sadar,Chapai Nababganj Paurashava,36,36,0,0,0,7,28,1,0
Rajshahi,Nawabganj,Nawabganj Sadar,Ranihati,4,4,0,0,0,0,4,0,0
Rajshahi,Nawabganj,Nawabganj Sadar,Balidanga,6,6,0,0,0,0,6,0,0
Rajshahi,Nawabganj,Nawabganj Sadar,Narayanpur,2,2,0,0,0,0,2,0,0
Rajshahi,Nawabganj,Nawabganj Sadar,Char Anupnagar,3,3,0,0,0,1,2,0,0
Rajshahi,Nawabganj,Nawabganj Sadar,Islampur,2,2,0,0,0,0,2,0,0
Rajshahi,Nawabganj,Nawabganj Sadar,Maharajpur,1,1,0,0,0,0,1,0,0
Rajshahi,Nawabganj,Nawabganj Sadar,Alatuli,0,0,0,0,0,0,0,0,0
Rajshahi,Nawabganj,Nawabganj Sadar,Baragharia,0,0,0,0,0,0,0,0,0
Rajshahi,Nawabganj,Nawabganj Sadar,###,97,97,0,0,0,9,84,4,0
Rajshahi,Nawabganj,###,###,161,161,0,0,0,12,134,15,0
Rajshahi,Pabna,Sujanagar,Hatkhali,1,1,0,0,0,0,0,1,0
Rajshahi,Pabna,Sujanagar,Manikhat,1,1,0,0,0,0,0,1,0
Rajshahi,Pabna,Sujanagar,Nazirganj,1,1,0,0,0,0,1,0,0
Rajshahi,Pabna,Sujanagar,Sujanagar Paurashava,1,1,0,0,0,0,1,0,0
Rajshahi,Pabna,Sujanagar,Sagarkandi,1,1,0,0,0,0,1,0,0
Rajshahi,Pabna,Sujanagar,Satbaria,1,1,0,0,0,0,1,0,0
Rajshahi,Pabna,Sujanagar,Tantibanda,1,1,0,0,0,0,0,0,1
Rajshahi,Pabna,Sujanagar,Dulai,1,1,0,0,0,0,1,0,0
Rajshahi,Pabna,Sujanagar,Ahammedpur,0,0,0,0,0,0,0,0,0
Rajshahi,Pabna,Sujanagar,Raninagar,0,0,0,0,0,0,0,0,0
Rajshahi,Pabna,Sujanagar,Sujanagar,0,0,0,0,0,0,0,0,0
Rajshahi,Pabna,Sujanagar,###,8,8,0,0,0,0,5,2,1
Rajshahi,Pabna,Atgharia,Lakshmipur,1,1,0,0,0,0,0,1,0
Rajshahi,Pabna,Atgharia,Chandba,2,2,0,0,0,0,2,0,0
Rajshahi,Pabna,Atgharia,Ekdanta,1,1,0,0,0,0,1,0,0
Rajshahi,Pabna,Atgharia,Debottar,2,2,0,0,0,1,1,0,0
Rajshahi,Pabna,Atgharia,Majh Para,1,1,0,0,0,0,1,0,0
Rajshahi,Pabna,Atgharia,Atgharia Paurashava,0,0,0,0,0,0,0,0,0
Rajshahi,Pabna,Atgharia,###,7,7,0,0,0,1,5,1,0
Rajshahi,Pabna,Chatmohar,Mulgram,2,2,0,0,0,0,2,0,0
Rajshahi,Pabna,Chatmohar,Chhaikhola,1,1,0,0,0,0,1,0,0
Rajshahi,Pabna,Chatmohar,Failjana,1,1,0,0,0,0,1,0,0
Rajshahi,Pabna,Chatmohar,Nimaichara,1,1,0,0,0,0,1,0,0
Rajshahi,Pabna,Chatmohar,Haripur,1,1,0,0,0,0,1,0,0
Rajshahi,Pabna,Chatmohar,Mothurapur,1,1,0,0,0,0,1,0,0
Rajshahi,Pabna,Chatmohar,Chatmohar Paurashava,1,1,0,0,0,0,1,0,0
Rajshahi,Pabna,Chatmohar,Bilchalan,0,0,0,0,0,0,0,0,0
Rajshahi,Pabna,Chatmohar,Danthia Bamangram,0,0,0,0,0,0,0,0,0
Rajshahi,Pabna,Chatmohar,Gunaigachha,0,0,0,0,0,0,0,0,0
Rajshahi,Pabna,Chatmohar,Handial,0,0,0,0,0,0,0,0,0
Rajshahi,Pabna,Chatmohar,Parshadanga,0,0,0,0,0,0,0,0,0
Rajshahi,Pabna,Chatmohar,###,8,8,0,0,0,0,8,0,0
Rajshahi,Pabna,Bhangura,Ashta Manisha,2,2,0,0,0,0,2,0,0
Rajshahi,Pabna,Bhangura,Bhangura Paurashava,1,1,0,0,0,0,1,0,0
Rajshahi,Pabna,Bhangura,Parbhanguria,2,2,0,0,0,0,2,0,0
Rajshahi,Pabna,Bhangura,Bhangura,2,2,0,0,0,0,2,0,0
Rajshahi,Pabna,Bhangura,Dil Pasar,0,0,0,0,0,0,0,0,0
Rajshahi,Pabna,Bhangura,Khan Marich,0,0,0,0,0,0,0,0,0
Rajshahi,Pabna,Bhangura,Munotosh,0,0,0,0,0,0,0,0,0
Rajshahi,Pabna,Bhangura,###,7,7,0,0,0,0,7,0,0
Rajshahi,Pabna,Santhia,Khatu Para,1,1,0,0,0,0,1,0,0
Rajshahi,Pabna,Santhia,Bhulbaria,2,2,0,0,0,0,2,0,0
Rajshahi,Pabna,Santhia,Ataikola,2,2,0,0,0,0,2,0,0
Rajshahi,Pabna,Santhia,Nagdemra,1,1,0,0,0,0,1,0,0
Rajshahi,Pabna,Santhia,Dhulauri,1,1,0,0,0,0,1,0,0
Rajshahi,Pabna,Santhia,Gaurigram,1,1,0,0,0,0,1,0,0
Rajshahi,Pabna,Santhia,Kashinathpur,3,3,0,0,0,0,3,0,0
Rajshahi,Pabna,Santhia,Santhia Paurashava,1,1,0,0,0,0,1,0,0
Rajshahi,Pabna,Santhia,Dhopadaha,1,1,0,0,0,0,1,0,0
Rajshahi,Pabna,Santhia,Karanja,1,1,0,0,0,0,1,0,0
Rajshahi,Pabna,Santhia,Nandanpur,0,0,0,0,0,0,0,0,0
Rajshahi,Pabna,Santhia,###,14,14,0,0,0,0,14,0,0
Rajshahi,Pabna,Pabna Sadar,Char Tarapur,1,1,0,0,0,0,1,0,0
Rajshahi,Pabna,Pabna Sadar,Ataikola,1,1,0,0,0,0,1,0,0
Rajshahi,Pabna,Pabna Sadar,Gayeshpur,1,1,0,0,0,0,1,0,0
Rajshahi,Pabna,Pabna Sadar,Dogachhi,1,1,0,0,0,0,1,0,0
Rajshahi,Pabna,Pabna Sadar,Sadullahpur,1,1,0,0,0,0,1,0,0
Rajshahi,Pabna,Pabna Sadar,Maligachha,2,2,0,0,0,0,1,1,0
Rajshahi,Pabna,Pabna Sadar,Bharara,1,1,0,0,0,0,1,0,0
Rajshahi,Pabna,Pabna Sadar,Malanchi,1,1,0,0,0,0,1,0,0
Rajshahi,Pabna,Pabna Sadar,Dapunia,1,1,0,0,0,0,1,0,0
Rajshahi,Pabna,Pabna Sadar,Hemayetpur,0,0,0,0,0,0,0,0,0
Rajshahi,Pabna,Pabna Sadar,Pabna Paurashava,0,0,0,0,0,0,0,0,0
Rajshahi,Pabna,Pabna Sadar,###,10,10,0,0,0,0,9,1,0
Rajshahi,Pabna,Faridpur,Faridpur,2,2,0,0,0,0,2,0,0
Rajshahi,Pabna,Faridpur,Bri-lahiribari,2,2,0,0,0,0,2,0,0
Rajshahi,Pabna,Faridpur,Faridpur Paurashava,2,2,0,0,0,0,2,0,0
Rajshahi,Pabna,Faridpur,Demra,1,1,0,0,0,0,1,0,0
Rajshahi,Pabna,Faridpur,Banwarinagar,0,0,0,0,0,0,0,0,0
Rajshahi,Pabna,Faridpur,Hadal,0,0,0,0,0,0,0,0,0
Rajshahi,Pabna,Faridpur,Pungali,0,0,0,0,0,0,0,0,0
Rajshahi,Pabna,Faridpur,###,7,7,0,0,0,0,7,0,0
Rajshahi,Pabna,Ishwardi,Ishwardi Paurashava,3,3,0,0,0,0,3,0,0
Rajshahi,Pabna,Ishwardi,Dashuria,1,1,0,0,0,0,1,0,0
Rajshahi,Pabna,Ishwardi,Silimpur,1,1,0,0,0,0,1,0,0
Rajshahi,Pabna,Ishwardi,Sara,1,1,0,0,0,0,1,0,0
Rajshahi,Pabna,Ishwardi,Muladuli,1,1,0,0,0,0,1,0,0
Rajshahi,Pabna,Ishwardi,Sahapur,2,2,0,0,0,0,2,0,0
Rajshahi,Pabna,Ishwardi,Pakshi,1,1,0,0,0,0,1,0,0
Rajshahi,Pabna,Ishwardi,Lakshmikundi,0,0,0,0,0,0,0,0,0
Rajshahi,Pabna,Ishwardi,###,10,10,0,0,0,0,10,0,0
Rajshahi,Pabna,Bera,Bera Paurashava,1,1,0,0,0,0,1,0,0
Rajshahi,Pabna,Bera,Puran Bharenga,1,1,0,0,0,0,1,0,0
Rajshahi,Pabna,Bera,Haturia Nakalia,1,1,0,0,0,0,1,0,0
Rajshahi,Pabna,Bera,Chakla,1,1,0,0,0,0,1,0,0
Rajshahi,Pabna,Bera,Masundia,2,2,0,0,0,0,2,0,0
Rajshahi,Pabna,Bera,Ruppur,1,1,0,0,0,0,1,0,0
Rajshahi,Pabna,Bera,Dhalar Char,0,0,0,0,0,0,0,0,0
Rajshahi,Pabna,Bera,Jatsakhni,0,0,0,0,0,0,0,0,0
Rajshahi,Pabna,Bera,Kytola,0,0,0,0,0,0,0,0,0
Rajshahi,Pabna,Bera,Nutan Bharenga,0,0,0,0,0,0,0,0,0
Rajshahi,Pabna,Bera,###,7,7,0,0,0,0,7,0,0
Rajshahi,Pabna,###,###,78,78,0,0,0,1,72,4,1
Rajshahi,Rajshahi,Godagari,Pakri,1,1,0,0,0,0,0,1,0
Rajshahi,Rajshahi,Godagari,Mohanpur,1,1,0,0,0,0,1,0,0
Rajshahi,Rajshahi,Godagari,Gogram,1,1,0,0,0,0,1,0,0
Rajshahi,Rajshahi,Godagari,Kakanhat Paurashava,1,1,0,0,0,0,1,0,0
Rajshahi,Rajshahi,Godagari,Basudebpur,1,1,0,0,0,0,1,0,0
Rajshahi,Rajshahi,Godagari,Deopara,1,1,0,0,0,0,1,0,0
Rajshahi,Rajshahi,Godagari,Godagari,1,1,0,0,0,0,1,0,0
Rajshahi,Rajshahi,Godagari,Godagari Paurashava,1,1,0,0,0,0,1,0,0
Rajshahi,Rajshahi,Godagari,Char Ashariadaha,0,0,0,0,0,0,0,0,0
Rajshahi,Rajshahi,Godagari,Matikata,0,0,0,0,0,0,0,0,0
Rajshahi,Rajshahi,Godagari,Rishikul,0,0,0,0,0,0,0,0,0
Rajshahi,Rajshahi,Godagari,###,8,8,0,0,0,0,7,1,0
Rajshahi,Rajshahi,Puthia,Silmaria,2,2,0,0,0,0,1,1,0
Rajshahi,Rajshahi,Puthia,Puthia Paurashava,1,1,0,0,0,0,1,0,0
Rajshahi,Rajshahi,Puthia,Bhalukgachhi,1,1,0,0,0,0,1,0,0
Rajshahi,Rajshahi,Puthia,Jeopara,2,2,0,0,0,0,1,1,0
Rajshahi,Rajshahi,Puthia,Baneshwar,2,2,0,0,0,0,2,0,0
Rajshahi,Rajshahi,Puthia,Belpukuria,1,1,0,0,0,0,1,0,0
Rajshahi,Rajshahi,Puthia,Puthia,0,0,0,0,0,0,0,0,0
Rajshahi,Rajshahi,Puthia,###,9,9,0,0,0,0,7,2,0
Rajshahi,Rajshahi,Tanore,Mundumala Paurashava,2,2,0,0,0,0,1,1,0
Rajshahi,Rajshahi,Tanore,Kalma,2,2,0,0,0,0,2,0,0
Rajshahi,Rajshahi,Tanore,Talanda,1,1,0,0,0,0,1,0,0
Rajshahi,Rajshahi,Tanore,Pachandar,1,1,0,0,0,0,1,0,0
Rajshahi,Rajshahi,Tanore,Kamargaon,1,1,0,0,0,0,1,0,0
Rajshahi,Rajshahi,Tanore,Tanore Paurashava,3,3,0,0,0,0,3,0,0
Rajshahi,Rajshahi,Tanore,Badhair,0,0,0,0,0,0,0,0,0
Rajshahi,Rajshahi,Tanore,Chanduria,0,0,0,0,0,0,0,0,0
Rajshahi,Rajshahi,Tanore,Saranjai,0,0,0,0,0,0,0,0,0
Rajshahi,Rajshahi,Tanore,###,10,10,0,0,0,0,9,1,0
Rajshahi,Rajshahi,Paba,Noahata Paurashava,2,2,0,0,0,0,2,0,0
Rajshahi,Rajshahi,Paba,Parila,1,1,0,0,0,0,1,0,0
Rajshahi,Rajshahi,Paba,Damkur,1,1,0,0,0,0,1,0,0
Rajshahi,Rajshahi,Paba,Darshan Para,1,1,0,0,0,0,1,0,0
Rajshahi,Rajshahi,Paba,Baragachhi,1,1,0,0,0,0,1,0,0
Rajshahi,Rajshahi,Paba,Katakhali Paurashava,1,1,0,0,0,0,1,0,0
Rajshahi,Rajshahi,Paba,Haripur,1,1,0,0,0,0,1,0,0
Rajshahi,Rajshahi,Paba,Hujuri Para,2,2,0,0,0,0,2,0,0
Rajshahi,Rajshahi,Paba,Haragram,0,0,0,0,0,0,0,0,0
Rajshahi,Rajshahi,Paba,Harian,0,0,0,0,0,0,0,0,0
Rajshahi,Rajshahi,Paba,###,10,10,0,0,0,0,10,0,0
Rajshahi,Rajshahi,Durgapur,Deluabari,1,1,0,0,0,0,1,0,0
Rajshahi,Rajshahi,Durgapur,Durgapur Paurashava,3,3,0,0,0,0,3,0,0
Rajshahi,Rajshahi,Durgapur,Joynagar,2,2,0,0,0,0,2,0,0
Rajshahi,Rajshahi,Durgapur,Jhaluka,1,1,0,0,0,0,1,0,0
Rajshahi,Rajshahi,Durgapur,Kismat Gankair,1,1,0,0,0,0,1,0,0
Rajshahi,Rajshahi,Durgapur,Dharmapur (Pananagar),0,0,0,0,0,0,0,0,0
Rajshahi,Rajshahi,Durgapur,Maria,0,0,0,0,0,0,0,0,0
Rajshahi,Rajshahi,Durgapur,Noapara,0,0,0,0,0,0,0,0,0
Rajshahi,Rajshahi,Durgapur,###,8,8,0,0,0,0,8,0,0
Rajshahi,Rajshahi,Bagha,Manigram,3,3,0,0,0,0,3,0,0
Rajshahi,Rajshahi,Bagha,Bausa,1,1,0,0,0,0,1,0,0
Rajshahi,Rajshahi,Bagha,Arani,1,1,0,0,0,0,1,0,0
Rajshahi,Rajshahi,Bagha,Bajubagha,2,2,0,0,0,0,2,0,0
Rajshahi,Rajshahi,Bagha,Bagha Paurashava,1,1,0,0,0,0,1,0,0
Rajshahi,Rajshahi,Bagha,Arani Paurashava,0,0,0,0,0,0,0,0,0
Rajshahi,Rajshahi,Bagha,Gargari,0,0,0,0,0,0,0,0,0
Rajshahi,Rajshahi,Bagha,Pakuria,0,0,0,0,0,0,0,0,0
Rajshahi,Rajshahi,Bagha,###,8,8,0,0,0,0,8,0,0
Rajshahi,Rajshahi,Mohanpur,Ghasigram,1,1,0,0,0,0,1,0,0
Rajshahi,Rajshahi,Mohanpur,Bakshimail,2,2,0,0,0,0,2,0,0
Rajshahi,Rajshahi,Mohanpur,Jahanabad,1,1,0,0,0,0,1,0,0
Rajshahi,Rajshahi,Mohanpur,Kesharhat Paurashava,1,1,0,0,0,0,0,1,0
Rajshahi,Rajshahi,Mohanpur,Dhurail,1,1,0,0,0,0,1,0,0
Rajshahi,Rajshahi,Mohanpur,Maugachhi,1,1,0,0,0,0,1,0,0
Rajshahi,Rajshahi,Mohanpur,Royghati,1,1,0,0,0,0,1,0,0
Rajshahi,Rajshahi,Mohanpur,###,8,8,0,0,0,0,7,1,0
Rajshahi,Rajshahi,Charghat,Nimpara,2,2,0,0,0,0,2,0,0
Rajshahi,Rajshahi,Charghat,Bhaya Lakshmipur,2,2,0,0,0,0,2,0,0
Rajshahi,Rajshahi,Charghat,Yusufpur,1,1,0,0,0,0,1,0,0
Rajshahi,Rajshahi,Charghat,Salua,2,2,0,0,0,0,2,0,0
Rajshahi,Rajshahi,Charghat,Charghat,1,1,0,0,0,0,1,0,0
Rajshahi,Rajshahi,Charghat,Charghat Paurashava,2,2,0,0,0,1,0,1,0
Rajshahi,Rajshahi,Charghat,Sardah,0,0,0,0,0,0,0,0,0
Rajshahi,Rajshahi,Charghat,###,10,10,0,0,0,1,8,1,0
Rajshahi,Rajshahi,Baghmara,Goalkandi,1,1,0,0,0,0,1,0,0
Rajshahi,Rajshahi,Baghmara,Maria,1,1,0,0,0,0,1,0,0
Rajshahi,Rajshahi,Baghmara,Bhabanigonj Paurashava,1,1,0,0,0,0,1,0,0
Rajshahi,Rajshahi,Baghmara,Jogi Para,1,1,0,0,0,0,1,0,0
Rajshahi,Rajshahi,Baghmara,Sreepur,1,1,0,0,0,0,1,0,0
Rajshahi,Rajshahi,Baghmara,Ganipur,1,1,0,0,0,0,1,0,0
Rajshahi,Rajshahi,Baghmara,Auch Para,0,0,0,0,0,0,0,0,0
Rajshahi,Rajshahi,Baghmara,Bara Bihanali,0,0,0,0,0,0,0,0,0
Rajshahi,Rajshahi,Baghmara,Basu Para,0,0,0,0,0,0,0,0,0
Rajshahi,Rajshahi,Baghmara,Dwippur,0,0,0,0,0,0,0,0,0
Rajshahi,Rajshahi,Baghmara,Gobinda Para,0,0,0,0,0,0,0,0,0
Rajshahi,Rajshahi,Baghmara,Hamir Kutsha,0,0,0,0,0,0,0,0,0
Rajshahi,Rajshahi,Baghmara,Jhikra,0,0,0,0,0,0,0,0,0
Rajshahi,Rajshahi,Baghmara,Kachhari Kayali Para,0,0,0,0,0,0,0,0,0
Rajshahi,Rajshahi,Baghmara,Nardas,0,0,0,0,0,0,0,0,0
Rajshahi,Rajshahi,Baghmara,Sonadanga,0,0,0,0,0,0,0,0,0
Rajshahi,Rajshahi,Baghmara,Subhadanga,0,0,0,0,0,0,0,0,0
Rajshahi,Rajshahi,Baghmara,Tahirpur Paurashava,0,0,0,0,0,0,0,0,0
Rajshahi,Rajshahi,Baghmara,###,6,6,0,0,0,0,6,0,0
Rajshahi,Rajshahi,Rajpara,Ward No-01,0,0,0,0,0,0,0,0,0
Rajshahi,Rajshahi,Rajpara,Ward No-03,0,0,0,0,0,0,0,0,0
Rajshahi,Rajshahi,Rajpara,Ward No-05,0,0,0,0,0,0,0,0,0
Rajshahi,Rajshahi,Rajpara,Ward No-06,0,0,0,0,0,0,0,0,0
Rajshahi,Rajshahi,Rajpara,Ward No-07,0,0,0,0,0,0,0,0,0
Rajshahi,Rajshahi,Rajpara,Ward No-10 (part),0,0,0,0,0,0,0,0,0
Rajshahi,Rajshahi,Rajpara,###,0,0,0,0,0,0,0,0,0
Rajshahi,Rajshahi,Boalia,Ward No-08,0,0,0,0,0,0,0,0,0
Rajshahi,Rajshahi,Boalia,Ward No-09,0,0,0,0,0,0,0,0,0
Rajshahi,Rajshahi,Boalia,Ward No-10 (part),0,0,0,0,0,0,0,0,0
Rajshahi,Rajshahi,Boalia,Ward No-11,0,0,0,0,0,0,0,0,0
Rajshahi,Rajshahi,Boalia,Ward No-12,0,0,0,0,0,0,0,0,0
Rajshahi,Rajshahi,Boalia,Ward No-13,0,0,0,0,0,0,0,0,0
Rajshahi,Rajshahi,Boalia,Ward No-14,0,0,0,0,0,0,0,0,0
Rajshahi,Rajshahi,Boalia,Ward No-15,0,0,0,0,0,0,0,0,0
Rajshahi,Rajshahi,Boalia,Ward No-16,0,0,0,0,0,0,0,0,0
Rajshahi,Rajshahi,Boalia,Ward No-18 (part),0,0,0,0,0,0,0,0,0
Rajshahi,Rajshahi,Boalia,Ward No-19,0,0,0,0,0,0,0,0,0
Rajshahi,Rajshahi,Boalia,Ward No-20,0,0,0,0,0,0,0,0,0
Rajshahi,Rajshahi,Boalia,Ward No-21,0,0,0,0,0,0,0,0,0
Rajshahi,Rajshahi,Boalia,Ward No-22,0,0,0,0,0,0,0,0,0
Rajshahi,Rajshahi,Boalia,Ward No-23,0,0,0,0,0,0,0,0,0
Rajshahi,Rajshahi,Boalia,Ward No-24,0,0,0,0,0,0,0,0,0
Rajshahi,Rajshahi,Boalia,Ward No-25,0,0,0,0,0,0,0,0,0
Rajshahi,Rajshahi,Boalia,Ward No-26,0,0,0,0,0,0,0,0,0
Rajshahi,Rajshahi,Boalia,Ward No-27,0,0,0,0,0,0,0,0,0
Rajshahi,Rajshahi,Boalia,###,0,0,0,0,0,0,0,0,0
Rajshahi,Rajshahi,Shah Makhdum,Ward No-17,0,0,0,0,0,0,0,0,0
Rajshahi,Rajshahi,Shah Makhdum,Ward No-18 (part),0,0,0,0,0,0,0,0,0
Rajshahi,Rajshahi,Shah Makhdum,###,0,0,0,0,0,0,0,0,0
Rajshahi,Rajshahi,Matihar,Ward No-28,0,0,0,0,0,0,0,0,0
Rajshahi,Rajshahi,Matihar,Ward No-29,0,0,0,0,0,0,0,0,0
Rajshahi,Rajshahi,Matihar,Ward No-30,0,0,0,0,0,0,0,0,0
Rajshahi,Rajshahi,Matihar,###,0,0,0,0,0,0,0,0,0
Rajshahi,Rajshahi,###,###,77,77,0,0,0,1,70,6,0
Rajshahi,Joypurhat,Joypurhat Sadar,Joypurhat Paurashava,2,2,0,0,0,1,0,1,0
Rajshahi,Joypurhat,Joypurhat Sadar,Chak Barkat,1,1,0,0,0,0,1,0,0
Rajshahi,Joypurhat,Joypurhat Sadar,Bhadsa,1,1,0,0,0,0,1,0,0
Rajshahi,Joypurhat,Joypurhat Sadar,Jamalpur,1,1,0,0,0,0,1,0,0
Rajshahi,Joypurhat,Joypurhat Sadar,Puranapail,1,1,0,0,0,0,1,0,0
Rajshahi,Joypurhat,Joypurhat Sadar,Dhalahar,1,1,0,0,0,0,1,0,0
Rajshahi,Joypurhat,Joypurhat Sadar,Amdai,1,1,0,0,0,0,1,0,0
Rajshahi,Joypurhat,Joypurhat Sadar,Bambu,1,1,0,0,0,0,1,0,0
Rajshahi,Joypurhat,Joypurhat Sadar,Dogachhi,1,1,0,0,0,0,1,0,0
Rajshahi,Joypurhat,Joypurhat Sadar,Mohammadabad,0,0,0,0,0,0,0,0,0
Rajshahi,Joypurhat,Joypurhat Sadar,###,10,10,0,0,0,1,8,1,0
Rajshahi,Joypurhat,Panchbibi,Bagjana,2,2,0,0,0,0,2,0,0
Rajshahi,Joypurhat,Panchbibi,Atapur,1,1,0,0,0,0,1,0,0
Rajshahi,Joypurhat,Panchbibi,Aymarasulpur,2,2,0,0,0,0,2,0,0
Rajshahi,Joypurhat,Panchbibi,Aolai,1,1,0,0,0,0,1,0,0
Rajshahi,Joypurhat,Panchbibi,Mohamadpur,1,1,0,0,0,0,1,0,0
Rajshahi,Joypurhat,Panchbibi,Kusumba,1,1,0,0,0,0,1,0,0
Rajshahi,Joypurhat,Panchbibi,Dharanji,1,1,0,0,0,1,0,0,0
Rajshahi,Joypurhat,Panchbibi,Balighata,0,0,0,0,0,0,0,0,0
Rajshahi,Joypurhat,Panchbibi,Panchbibi Paurashava,0,0,0,0,0,0,0,0,0
Rajshahi,Joypurhat,Panchbibi,###,9,9,0,0,0,1,8,0,0
Rajshahi,Joypurhat,Akkelpur,Sonamukhi,1,1,0,0,0,0,1,0,0
Rajshahi,Joypurhat,Akkelpur,Tilakpur,1,1,0,0,0,0,1,0,0
Rajshahi,Joypurhat,Akkelpur,Akkelpur Paurashava,1,1,0,0,0,0,1,0,0
Rajshahi,Joypurhat,Akkelpur,Rukindipur,2,2,0,0,0,0,2,0,0
Rajshahi,Joypurhat,Akkelpur,Raikali,1,1,0,0,0,0,1,0,0
Rajshahi,Joypurhat,Akkelpur,Gopinathpur,1,1,0,0,0,0,1,0,0
Rajshahi,Joypurhat,Akkelpur,###,7,7,0,0,0,0,7,0,0
Rajshahi,Joypurhat,Khetlal,Mamudpur,1,1,0,0,0,0,1,0,0
Rajshahi,Joypurhat,Khetlal,Barail,1,1,0,0,0,0,1,0,0
Rajshahi,Joypurhat,Khetlal,Alampur,2,2,0,0,0,0,2,0,0
Rajshahi,Joypurhat,Khetlal,Batara,1,1,0,0,0,0,1,0,0
Rajshahi,Joypurhat,Khetlal,Khetlal,1,1,0,0,0,0,1,0,0
Rajshahi,Joypurhat,Khetlal,###,6,6,0,0,0,0,6,0,0
Rajshahi,Joypurhat,Kalai,Zindarpur,2,2,0,0,0,0,2,0,0
Rajshahi,Joypurhat,Kalai,Udaypur,1,1,0,0,0,0,1,0,0
Rajshahi,Joypurhat,Kalai,Kalai Paurashava,2,2,0,0,0,0,1,1,0
Rajshahi,Joypurhat,Kalai,Matrai,1,1,0,0,0,0,1,0,0
Rajshahi,Joypurhat,Kalai,Punat,1,1,0,0,0,1,0,0,0
Rajshahi,Joypurhat,Kalai,Ahmmedabad,0,0,0,0,0,0,0,0,0
Rajshahi,Joypurhat,Kalai,###,7,7,0,0,0,1,5,1,0
Rajshahi,Joypurhat,###,###,39,39,0,0,0,3,34,2,0
Rajshahi,Bogra,Bogra Sadar,Bogra Paurashava,2,2,0,0,0,0,2,0,0
Rajshahi,Bogra,Bogra Sadar,Noongola,1,1,0,0,0,0,1,0,0
Rajshahi,Bogra,Bogra Sadar,Nishindara,1,1,0,0,0,0,1,0,0
Rajshahi,Bogra,Bogra Sadar,Namuja,1,1,0,0,0,0,1,0,0
Rajshahi,Bogra,Bogra Sadar,Lahiri Para,1,1,0,0,0,0,1,0,0
Rajshahi,Bogra,Bogra Sadar,Shakharia,1,1,0,0,0,0,1,0,0
Rajshahi,Bogra,Bogra Sadar,Erulia,0,0,0,0,0,0,0,0,0
Rajshahi,Bogra,Bogra Sadar,Fapore,0,0,0,0,0,0,0,0,0
Rajshahi,Bogra,Bogra Sadar,Gokul,0,0,0,0,0,0,0,0,0
Rajshahi,Bogra,Bogra Sadar,Rajapur,0,0,0,0,0,0,0,0,0
Rajshahi,Bogra,Bogra Sadar,Sekherkola,0,0,0,0,0,0,0,0,0
Rajshahi,Bogra,Bogra Sadar,Shabgram,0,0,0,0,0,0,0,0,0
Rajshahi,Bogra,Bogra Sadar,###,7,7,0,0,0,0,7,0,0
Rajshahi,Bogra,Sherpur,Mirzapur,1,1,0,0,0,0,1,0,0
Rajshahi,Bogra,Sherpur,Kusumbi,2,2,0,0,0,0,2,0,0
Rajshahi,Bogra,Sherpur,Sherpur Paurashava,1,1,0,0,0,0,1,0,0
Rajshahi,Bogra,Sherpur,Bhabanipur,1,1,0,0,0,0,1,0,0
Rajshahi,Bogra,Sherpur,Bishalpur,1,1,0,0,0,0,1,0,0
Rajshahi,Bogra,Sherpur,Garidaha,1,1,0,0,0,0,1,0,0
Rajshahi,Bogra,Sherpur,Shimabari,1,1,0,0,0,0,1,0,0
Rajshahi,Bogra,Sherpur,Khamarkandi,0,0,0,0,0,0,0,0,0
Rajshahi,Bogra,Sherpur,Khanpur,0,0,0,0,0,0,0,0,0
Rajshahi,Bogra,Sherpur,Shah- Bandegi,0,0,0,0,0,0,0,0,0
Rajshahi,Bogra,Sherpur,Sughat,0,0,0,0,0,0,0,0,0
Rajshahi,Bogra,Sherpur,###,8,8,0,0,0,0,8,0,0
Rajshahi,Bogra,Adamdighi,Champapur,1,1,0,0,0,0,1,0,0
Rajshahi,Bogra,Adamdighi,Kundagram,1,1,0,0,0,0,1,0,0
Rajshahi,Bogra,Adamdighi,Adam Dighi,1,1,0,0,0,0,1,0,0
Rajshahi,Bogra,Adamdighi,Shantahar,1,1,0,0,0,0,1,0,0
Rajshahi,Bogra,Adamdighi,Chhatiangram,1,1,0,0,0,0,1,0,0
Rajshahi,Bogra,Adamdighi,Nasratpur,1,1,0,0,0,0,1,0,0
Rajshahi,Bogra,Adamdighi,Santahar Paurashava,0,0,0,0,0,0,0,0,0
Rajshahi,Bogra,Adamdighi,###,6,6,0,0,0,0,6,0,0
Rajshahi,Bogra,Kahaloo,Narahatta,1,1,0,0,0,0,1,0,0
Rajshahi,Bogra,Kahaloo,Durgapur,2,2,0,0,0,0,2,0,0
Rajshahi,Bogra,Kahaloo,Bir Kedar,1,1,0,0,0,0,1,0,0
Rajshahi,Bogra,Kahaloo,Jamgaon,1,1,0,0,0,0,1,0,0
Rajshahi,Bogra,Kahaloo,Kahaloo Paurashava,1,1,0,0,0,0,1,0,0
Rajshahi,Bogra,Kahaloo,Urail,1,1,0,0,0,0,1,0,0
Rajshahi,Bogra,Kahaloo,Paikar,1,1,0,0,0,1,0,0,0
Rajshahi,Bogra,Kahaloo,Kalai Majh Para,1,1,0,0,0,0,1,0,0
Rajshahi,Bogra,Kahaloo,Malancha,1,1,0,0,0,0,1,0,0
Rajshahi,Bogra,Kahaloo,Kahaloo,0,0,0,0,0,0,0,0,0
Rajshahi,Bogra,Kahaloo,###,10,10,0,0,0,1,9,0,0
Rajshahi,Bogra,Shajahanpur,Gohail,1,1,0,0,0,0,1,0,0
Rajshahi,Bogra,Shajahanpur,Chopinagar,1,1,0,0,0,0,1,0,0
Rajshahi,Bogra,Shajahanpur,Khotta Para,1,1,0,0,0,0,1,0,0
Rajshahi,Bogra,Shajahanpur,Majhira,1,1,0,0,0,0,1,0,0
Rajshahi,Bogra,Shajahanpur,Kharna,1,1,0,0,0,0,1,0,0
Rajshahi,Bogra,Shajahanpur,Asekpur,1,1,0,0,0,0,1,0,0
Rajshahi,Bogra,Shajahanpur,Amrool,1,1,0,0,0,0,1,0,0
Rajshahi,Bogra,Shajahanpur,Aria,0,0,0,0,0,0,0,0,0
Rajshahi,Bogra,Shajahanpur,Madla,0,0,0,0,0,0,0,0,0
Rajshahi,Bogra,Shajahanpur,Paurashava,0,0,0,0,0,0,0,0,0
Rajshahi,Bogra,Shajahanpur,Sultanganj (Part),0,0,0,0,0,0,0,0,0
Rajshahi,Bogra,Shajahanpur,###,7,7,0,0,0,0,7,0,0
Rajshahi,Bogra,Sariakandi,Hat Sherpur,1,1,0,0,0,0,1,0,0
Rajshahi,Bogra,Sariakandi,Kamalpur,1,1,0,0,0,0,1,0,0
Rajshahi,Bogra,Sariakandi,Fulbari,1,1,0,0,0,0,1,0,0
Rajshahi,Bogra,Sariakandi,Karnibari,1,1,0,0,0,1,0,0,0
Rajshahi,Bogra,Sariakandi,Chaluabari,1,1,0,0,0,1,0,0,0
Rajshahi,Bogra,Sariakandi,Bhelabari,1,1,0,0,0,0,1,0,0
Rajshahi,Bogra,Sariakandi,Kazla,1,1,0,0,0,1,0,0,0
Rajshahi,Bogra,Sariakandi,Sariakandi Paurashava,2,1,1,1,0,1,0,0,0
Rajshahi,Bogra,Sariakandi,Narchi,2,2,0,0,0,1,1,0,0
Rajshahi,Bogra,Sariakandi,Bohail,0,0,0,0,0,0,0,0,0
Rajshahi,Bogra,Sariakandi,Chandan Baisha,0,0,0,0,0,0,0,0,0
Rajshahi,Bogra,Sariakandi,Kutubpur,0,0,0,0,0,0,0,0,0
Rajshahi,Bogra,Sariakandi,Sariakandi,0,0,0,0,0,0,0,0,0
Rajshahi,Bogra,Sariakandi,###,11,10,1,1,0,5,5,0,0
Rajshahi,Bogra,Nandigram,Bhatgram,1,1,0,0,0,0,1,0,0
Rajshahi,Bogra,Nandigram,Thalta Majhgram,1,1,0,0,0,0,1,0,0
Rajshahi,Bogra,Nandigram,Nandigram Paurashava,1,1,0,0,0,0,1,0,0
Rajshahi,Bogra,Nandigram,Burail,1,1,0,0,0,0,1,0,0
Rajshahi,Bogra,Nandigram,Bhatra,1,1,0,0,0,0,1,0,0
Rajshahi,Bogra,Nandigram,Nandigram,0,0,0,0,0,0,0,0,0
Rajshahi,Bogra,Nandigram,###,5,5,0,0,0,0,5,0,0
Rajshahi,Bogra,Dhupchanchia,Chamrul,1,1,0,0,0,0,1,0,0
Rajshahi,Bogra,Dhupchanchia,Dhupchanchia Paurashava,2,2,0,0,0,0,2,0,0
Rajshahi,Bogra,Dhupchanchia,Gunahar,1,1,0,0,0,1,0,0,0
Rajshahi,Bogra,Dhupchanchia,Zianagar,1,1,0,0,0,0,1,0,0
Rajshahi,Bogra,Dhupchanchia,Gobindapur,1,1,0,0,0,0,1,0,0
Rajshahi,Bogra,Dhupchanchia,Dhupchanchia,0,0,0,0,0,0,0,0,0
Rajshahi,Bogra,Dhupchanchia,Talora,0,0,0,0,0,0,0,0,0
Rajshahi,Bogra,Dhupchanchia,###,6,6,0,0,0,1,5,0,0
Rajshahi,Bogra,Gabtali,Gabtali Paurashava,2,2,0,0,0,1,1,0,0
Rajshahi,Bogra,Gabtali,Mahishaban,2,2,0,0,0,1,1,0,0
Rajshahi,Bogra,Gabtali,Nasipur,1,1,0,0,0,0,1,0,0
Rajshahi,Bogra,Gabtali,Nepaltali,1,1,0,0,0,0,1,0,0
Rajshahi,Bogra,Gabtali,Sonarai,1,1,0,0,0,0,1,0,0
Rajshahi,Bogra,Gabtali,Durgahata,1,1,0,0,0,1,0,0,0
Rajshahi,Bogra,Gabtali,Rameshwarpur,1,1,0,0,0,0,1,0,0
Rajshahi,Bogra,Gabtali,Balia Dighi,0,0,0,0,0,0,0,0,0
Rajshahi,Bogra,Gabtali,Dakshinpara Union,0,0,0,0,0,0,0,0,0
Rajshahi,Bogra,Gabtali,Gabtali,0,0,0,0,0,0,0,0,0
Rajshahi,Bogra,Gabtali,Kagail,0,0,0,0,0,0,0,0,0
Rajshahi,Bogra,Gabtali,Naruamala,0,0,0,0,0,0,0,0,0
Rajshahi,Bogra,Gabtali,###,9,9,0,0,0,3,6,0,0
Rajshahi,Bogra,Shibganj,Saidpur,1,1,0,0,0,0,1,0,0
Rajshahi,Bogra,Shibganj,Buriganj,1,1,0,0,0,0,1,0,0
Rajshahi,Bogra,Shibganj,Shibganj,2,2,0,0,0,1,1,0,0
Rajshahi,Bogra,Shibganj,Kichak,1,1,0,0,0,0,1,0,0
Rajshahi,Bogra,Shibganj,Pirab,1,1,0,0,0,0,1,0,0
Rajshahi,Bogra,Shibganj,Roynagar,1,1,0,0,0,0,1,0,0
Rajshahi,Bogra,Shibganj,Atmul,1,1,0,0,0,0,1,0,0
Rajshahi,Bogra,Shibganj,Mokamtala,1,1,0,0,0,0,1,0,0
Rajshahi,Bogra,Shibganj,Shibganj Paurashava,1,1,0,0,0,0,1,0,0
Rajshahi,Bogra,Shibganj,Bihar,0,0,0,0,0,0,0,0,0
Rajshahi,Bogra,Shibganj,Deuli,0,0,0,0,0,0,0,0,0
Rajshahi,Bogra,Shibganj,Maidanhata,0,0,0,0,0,0,0,0,0
Rajshahi,Bogra,Shibganj,Majhihatta,0,0,0,0,0,0,0,0,0
Rajshahi,Bogra,Shibganj,###,10,10,0,0,0,1,9,0,0
Rajshahi,Bogra,Sonatola,Digdair,1,1,0,0,0,1,0,0,0
Rajshahi,Bogra,Sonatola,Sonatola Paurashava,1,1,0,0,0,0,1,0,0
Rajshahi,Bogra,Sonatola,Madhupur,1,1,0,0,0,0,1,0,0
Rajshahi,Bogra,Sonatola,Pakulla,1,1,0,0,0,0,1,0,0
Rajshahi,Bogra,Sonatola,Tekani Chukainagar,1,1,0,0,0,0,1,0,0
Rajshahi,Bogra,Sonatola,Jorgachha,1,1,0,0,0,0,1,0,0
Rajshahi,Bogra,Sonatola,Balua,1,1,0,0,0,0,1,0,0
Rajshahi,Bogra,Sonatola,Sonatala,0,0,0,0,0,0,0,0,0
Rajshahi,Bogra,Sonatola,###,7,7,0,0,0,1,6,0,0
Rajshahi,Bogra,Dhunat,Nimgachhi,1,1,0,0,0,0,1,0,0
Rajshahi,Bogra,Dhunat,Bhandarbari,1,1,0,0,0,0,1,0,0
Rajshahi,Bogra,Dhunat,Dhunat Paurashava,1,1,0,0,0,0,1,0,0
Rajshahi,Bogra,Dhunat,Mathurapur,1,1,0,0,0,0,1,0,0
Rajshahi,Bogra,Dhunat,Chikashi,1,1,0,0,0,0,1,0,0
Rajshahi,Bogra,Dhunat,Chaukibari,1,1,0,0,0,0,1,0,0
Rajshahi,Bogra,Dhunat,Kaler Para,1,1,0,0,0,0,1,0,0
Rajshahi,Bogra,Dhunat,Gosainbari,1,1,0,0,0,0,1,0,0
Rajshahi,Bogra,Dhunat,Dhunat,0,0,0,0,0,0,0,0,0
Rajshahi,Bogra,Dhunat,Elangi,0,0,0,0,0,0,0,0,0
Rajshahi,Bogra,Dhunat,Gopalnagar,0,0,0,0,0,0,0,0,0
Rajshahi,Bogra,Dhunat,###,8,8,0,0,0,0,8,0,0
Rajshahi,Bogra,###,###,94,93,1,1,0,12,81,0,0
Rajshahi,###,###,###,680,677,3,3,0,40,597,32,8
